Symbol	Description
A	Agilent Technologies
AA	Alcoa Corp
AAC	Aac Holdings Inc
AAN	Aaron's Inc
AAP	Advance Auto Parts Inc
AAT	American Assets Trust
AB	Alliancebernstein Holding LP
ABB	Abb Ltd
ABBV	Abbvie Inc
ABC	Amerisourcebergen Corp
ABEV	Ambev S.A.
ABG	Asbury Automotive Group Inc
ABM	ABM Industries Incorporated
ABR	Arbor Realty Trust
ABR-A	Arbor Rlty TR Inc [Abr/Pa]
ABR-B	Arbor Rlty TR Inc [Abr/Pb]
ABR-C	Arbor Rlty TR Inc [Abr/Pc]
ABT	Abbott Laboratories
AC	Associated Capital Group Inc
ACA	Arcosa Inc
ACB	Aurora Cannabis Inc
ACC	American Campus Communities Inc
ACCO	Acco Brands Corp
ACH	Aluminum Corp of China Ltd
ACM	Aecom Technology Corp
ACN	Accenture Plc
ACP	Avenue Income Credit Strategies
ACP.P	Avenue Income Credit Strategies
ACRE	Ares Commercial Real Estate Cor
ACV	Allianzgi Diversified Income &
ADC	Agree Realty Corp
ADM	Archer Daniels Midland
ADNT	Adient Plc
ADS	Alliance Data Systems Corp
ADSW	Advanced Disposal Services Inc
ADT	ADT Inc
ADX	Adams Express Company
AEB	Aegon N.V. Perp Cap Secs Floating Rate [Ne]
AEE	Ameren Corp
AEG	Aegon N.V.
AEH	Aegon N.V. Perp Cap Secs
AEL	American Equity Investment Life
AEM	Agnico-Eagle Mines Ltd
AEO	American Eagle Outfitters
AEP	American Electric Power Company
AEP-B	American Elec Pwr Co. Inc [Aep/Pb]
AER	Aercap Holdings N.V.
AES	The Aes Corp
AFB	Alliance National Municipal
AFC	Allied Capital Corp
AFG	American Financial Group
AFGB	American Financial Group Inc 5.875% Subordinat
AFGE	American Financial Group Inc
AFGH	American Financial Group Inc
AFI	Armstrong Flooring Inc
AFL	Aflac Incorporated
AFT	Apollo Senior Floating Rate Fund Inc
AG	First Majestic Silver
AGCO	Agco Corp
AGD	Alpine Global Dynamic Dividend Fund
AGI	Alamos Gold Inc
AGM	Federal Agricultural Mortgage Corp
AGM-A	Federal Agricultural Mortgage Corp [Agm/Pa]
AGM-C	Federal Agricultural Mortgage Corp [Agm/Pc]
AGM-D	Federal Agricultural Mortgage Corp [Agm/Pd]
AGM.A	Federal Agricultural Mortgage Corp
AGN	Allergan Plc
AGO	Assured Guaranty Ltd
AGO-B	Assured Guaranty Municipal Hldgs IN [Ago/Pb]
AGO-E	Assured Guaranty Municipal Hldgs IN [Ago/Pe]
AGO-F	Assured Guaranty Municipal Hldgs IN [Ago/Pf]
AGR	Avangrid Inc
AGRO	Adecoagro S.A.
AGS	Playags Inc
AGX	Argan Inc
AHC	A.H. Belo Corp
AHH	Armada Hoffler Properties Inc
AHH-A	Armada Hoffler Pptys Inc [Ahh/Pa]
AHL-C	Aspen Insurance Holdings Ltd [Ahl/Pc]
AHL-D	Aspen Insurance Holdings Ltd [Ahl/Pd]
AHL-E	Aspen Insurance Holdings Ltd [Ahl/Pe]
AHT	Ashford Hospitality Trust Inc
AHT-D	Ashford Hospitality TR Inc [Aht/Pd]
AHT-F	Ashford Hospitality TR Inc [Aht/Pf]
AHT-G	Ashford Hospitality TR Inc [Aht/Pg]
AHT-H	Ashford Hospitality TR Inc [Aht/Ph]
AHT-I	Ashford Hospitality TR Inc [Aht/Pi]
AI	Arlington Asset Investment Corp
AI-B	Arlington Asset Investment Corp [Ai/Pb]
AI-C	Arlington Asset Investment Corp [Ai/Pc]
AIC	Arlington Asset Investment Cor
AIF	Apollo Tactical Income Fund Inc
AIG	American International Group
AIG-A	American International Group Inc [Aig/Pa]
AIG.W	American Intl Group Inc [Aig/W]
AIN	Albany International Corp
AIR	AAR Corp
AIT	Applied Industrial Technologies
AIV	Apartment Investment and Management
AIW	Arlington Asset Investment Cor
AIZ	Assurant Inc
AIZP	Assurant Inc 6.50% Series D Mandatory Converti
AJG	Arthur J. Gallagher & Company
AJRD	Aerojet Rocketdyne Holdings
AJX	Great Ajax Corp
AJXA	Great Ajax Corp 7.25% Convertible Senior Notes
AKO.A	Embotell Andina Sa Cl A
AKO.B	Embotell Andna Sa Cl B
AKR	Acadia Realty Trust
AKS	AK Steel Holding Corp
AL	Air Lease Corp Cl A
AL-A	Air Lease Corp [Al/Pa]
ALB	Albemarle Corp
ALC	Alcon Inc
ALE	Allete Inc
ALEX	Alexander and Baldwin Inc
ALG	Alamo Group
ALK	Alaska Air Group
ALL	Allstate Corp
ALL-A	Allstate Corp [All/Pa]
ALL-B	Allstate Corp [All/Pb]
ALL-D	Allstate Corp [All/Pd]
ALL-E	Allstate Corp [All/Pe]
ALL-F	Allstate Corp [All/Pf]
ALL-G	Allstate Corp [All/Pg]
ALL-H	Allstate Corp [All/Ph]
ALL-Y	GMAC Capital Trust I [Ally/Pa]
ALLE	Allegion Plc
ALLY	Ally Financial
ALP-Q	Alabama Power Co. [Alp/Pq]
ALSN	Allison Transmission Holdings
ALV	Autoliv Inc
ALX	Alexander's Inc
AM	Antero Midstream Corp
AMC	Amc Entertainment Holdings Inc
AMCR	Amcor Plc
AME	Amtek Inc
AMG	Affiliated Managers Group
AMH	American Homes 4 Rent
AMH-D	American Homes 4 Rent [Amh/Pd]
AMH-E	American Homes 4 Rent [Amh/Pe]
AMH-F	American Homes 4 Rent [Amh/Pf]
AMH-G	American Homes 4 Rent [Amh/Pg]
AMH-H	American Homes 4 Rent [Amh/Ph]
AMK	Assetmark Financial Holdings Inc
AMN	Amn Healthcare Services Inc
AMOV	America Movil A ADR
AMP	Ameriprise Financial Services
AMPY	Amplify Energy Corp
AMRC	Ameresco Inc
AMRX	Amneal Pharmaceuticals Inc
AMT	American Tower Corp
AMX	America Movil S.A.B. DE C.V.
AN	Autonation Inc
ANET	Arista Networks Inc
ANF	Abercrombie & Fitch Company
ANFI	Amira Nature Foods Ltd
ANH	Anworth Mortgage Asset Corp
ANH-A	Anworth Mortgage Asset Cp [Anh/Pa]
ANH-B	Anworth Mortgage Asset Cp [Anh/Pb]
ANH-C	Anworth Mortgage Asset Cp [Anh/Pc]
ANTM	Anthem Inc
AOD	Alpine Total Dynamic Dividend
AON	AON Plc
AOS	Smith [A.O.] Corp
AP	Ampco-Pittsburgh Corp
APA	Apache Corp
APAM	Artisan Partners Asset Mgmt
APD	Air Products and Chemicals
APH	Amphenol Corp
APHA	Aphria Inc
APLE	Apple Hospitality REIT Inc
APO	Apollo Global Management Llc C
APO-A	Apollo Global Mgmt Inc [Apo/Pa]
APO-B	Apollo Global Mgmt Inc [Apo/Pb]
APRN	Blue Apron Holdings Inc
APTS	Preferred Apartment Communities
APTV	Aptiv Plc
APY	Apergy Corp
AQN	Algonquin Pwr & Util
AQNA	Algonquin Power & Utilities Corp
AQNB	Algonquin Power & Utilities Corp. 6.20% Fixed-To
AQUA	Evoqua Water Technologies Corp
AR	Antero Resources Corp
ARA	American Renal Associates
ARC	American Reprographics Company
ARCH	Arch Coal Inc
ARCO	Arcos Dorados Holdings Inc
ARD	Ardagh Group S.A.
ARDC	Ares Dynamic Credit Allocation
ARE	Alexandria Real Estate Equities
ARE-A	Ares Management Corp [Ares/Pa]
ARE-D	Alexandria Real Estate Eq Inc [Are/Pd]
ARES	Ares Management LP
ARGD	Argo Grp Itl Snr NTS
ARGO	Argo Group Intl Hlds
ARI	Apollo Commercial Real Estate
ARL	American Realty Investors
ARLO	Arlo Technologies Inc
ARMK	Aramark Holdings Corp
ARNC	Arconic Inc
AROC	Archrock Inc
ARR	Armour Residential R
ARR-B	Armour Residential REIT Inc [Arr/Pb]
ARW	Arrow Electronics
ASA	ASA Gold and Precious Metals
ASB	Associated Banc-Corp
ASB-C	Associated Banc-Corp [Asb/Pc]
ASB-D	Associated Banc-Corp [Asb/Pd]
ASB-E	Associated Banc-Corp [Asb/Pe]
ASC	Ardmore Shipping Corp
ASG	Liberty All-Star Growth Fund
ASGN	On Assignment
ASH	Ashland Global Holdings Inc
ASIX	Advansix Inc
ASPN	Aspen Aerogels Inc
ASR	Grupo Aeroportuario Del Sureste
ASX	Ase Industrial Holding Co. Ltd
AT	Atlantic Power Corp
ATEN	A10 Networks Inc
ATGE	Adtalem Global Education Inc
ATH	Athene Holding Ltd
ATH-A	Athene Hldg Ltd [Ath/Pa]
ATH-B	Antah Hldgs Ltd
ATHM	Autohome Inc
ATI	Allegheny Technologies Inc
ATKR	Atkore International Group
ATO	Atmos Energy Corp
ATR	Aptargroup
ATTO	Atento S.A.
ATU	Actuant Corp
ATUS	Altice USA Inc Cl A
ATV	Acorn International
AU	Anglogold Ashanti Ltd
AUO	Au Optronics Corp
AUY	Yamana Gold
AVA	Avista Corp
AVAL	Grupo Aval Acciones Y Valores S
AVB	Avalonbay Communities
AVD	American Vanguard Corp
AVH	Avianca Holdings S.A.
AVK	Advent Claymore Convertible Securities
AVLR	Avalara Inc
AVNS	Avanos Medical Inc
AVP	Avon Products
AVT-A	Avantor Inc [Avtr/Pa]
AVTR	Avantor Inc
AVX	Avx Corp
AVY	Avery Dennison Corp
AVYA	Avaya Holdings Corp
AWF	Alliancebernstein Global High Income Fund
AWI	Armstrong World Industries Inc
AWK	American Water Works
AWP	Alpine Global Premier Propertie
AWR	American States Water Company
AX	Axos Financial Inc
AXE	Anixter International Inc
AXL	American Axle & Manufacturing
AXO	Axos Financial Inc
AXP	American Express Company
AXR	Amrep Corp
AXS	Axis Capital Holdings
AXS-D	Axis Capital Holdings Ltd [Axs/Pd]
AXS-E	Axis Capital Holdings Ltd [Axs/Pe]
AXTA	Axalta Coating Systems Ltd
AYI	Acuity Brands Inc
AYR	Aircastle Ltd
AYX	Alteryx Inc
AZN	Astrazeneca Plc
AZO	Autozone
AZRE	Azure Power Global Ltd
AZUL	Azul S.A. ADR
AZZ	Azz Inc
B	Barnes Group
BA	Boeing Company
BABA	Alibaba Group Holding
BAC	Bank of America Corp
BAC-A	Bank of America Corp [Bac/Pa]
BAC-B	Bank of America Corp [Bac/Pb]
BAC-C	Bank of America Corp [Bac/Pc]
BAC-E	Bank of America Corp [Bac/Pe]
BAC-K	Bank of America Corp [Bac/Pk]
BAC-L	Bank of America Corp [Bac/Pl]
BAC-M	Bank of America Corp [Bac/Pm]
BAC-N	Bank of America Corp. Prf Perpetual USD Ser LL D
BAC-Y	Bank of America Corp [Bac/Py]
BAF	Blackrock Income Inv Quality Trust
BAH	Booz Allen Hamilton Holding Corp
BAM	Brookfield Asset Management Inc
BAN-D	Banc of California Inc [Banc/Pd]
BAN-E	Banc of California Inc [Banc/Pe]
BANC	First Pactrust Bancorp
BAP	Credicorp Ltd
BAS	Basic Energy Services
BAX	Baxter International Inc
BB	Blackberry Ltd
BBAR	Bbva Banco Frances S.A.
BBD	Banco Bradesco S.A.
BBDC	Barings Bdc Inc
BBDO	Banco Bradesco S.A.
BBF	Blackrock Muni Income Trust
BBK	Blackrock Muni Trust
BBL	Bhp Billiton Plc
BBN	Balckrock Build America Trust
BBT	BB&T Corp
BBT-F	BB&T Corp [Bbt/Pf]
BBT-G	BB&T Corp [Bbt/Pg]
BBT-H	BB&T Corp [Bbt/Ph]
BBU	Brookfield Business Partners LP
BBVA	Banco Bilbao Viscaya Argentaria S.A.
BBW	Build-A-Bear Workshop
BBX	Bbx Capital Corp
BBY	Best Buy Company
BC	Brunswick Corp
BC-A	Brunswick Corp [Bc/Pa]
BC-B	Brunswick Corp [Bc/Pb]
BC-C	Brunswick Corp [Bc/Pc]
BCC	Boise Cascade L.L.C.
BCE	BCE Inc
BCEI	Bonanza Creek Energy Inc
BCH	Banco DE Chile
BCO	Brink's Company
BCRH	Blue Capital Reinsurance
BCS	Barclays Plc
BCSF	Bain Capital Specialty Finance Inc
BCX	Blackrock Resources
BDC	Belden Inc
BDJ	Blackrock Enhanced Dividend Achievers
BDN	Brandywine Realty Trust
BDX	Becton Dickinson and Company
BDXA	Becton Dickinson & Company
BE	Bloom Energy Corp Cl A
BEDU	Bright Scholar Education Holdings Ltd
BEN	Franklin Resources
BEP	Brookfield Renewable
BERY	Berry Global Group
BEST	Best Inc
BF.A	Brown Forman Inc Cl A
BF.B	Brown Forman Inc Cl B
BFAM	Bright Horizons Family Solutions Inc
BFK	Blackrock Muni Income Trust
BFO	Blackrock Florida Muni 2020 Trust
BFS	Saul Centers
BFS-C	Saul Ctrs Inc [Bfs/Pc]
BFS-D	Saul Ctrs Inc [Bfs/Pd]
BFS-E	Saul Centers Inc Prf Perpetual USD Ser E Rep 1/1
BFY	Blackrock New York Muni Trust II
BFZ	Blackrock California Muni Trust
BG	Bunge Ltd
BGB	Blackstone / Gso Strategic Cre
BGG	Briggs & Stratton Corp
BGH	Babson Capital Global Short Du
BGIO	Blackrock 2022 Global Income Opportunity Trust
BGR	Blackrock Energy and Resources Trust
BGS	B&G Foods Holdings
BGT	Blackrock Global
BGX	Blackstone Gso Long Short Credit Fund
BGY	Blackrock International
BH	Biglari Holdings Inc
BH.A	Biglari Holdings Inc Cl A
BHC	Bausch Health Companies Inc
BHE	Benchmark Electronics
BHGE	Baker Hughes A Ge Co. Cl A
BHK	Blackrock Core Trust
BHLB	Berkshire Hills Bancorp
BHP	Bhp Billiton Ltd
BHR	Braemar Hotels & Resorts Inc
BHR-B	Braemar Hotels & Resorts Inc [Bhr/Pb]
BHR-D	Braemar Hotels & Resorts Inc [Bhr/Pd]
BHV	Blackrock Virginia Muni Trust
BHVN	Biohaven Pharmaceutical Holding Company Ltd
BID	Sotheby's Holdings
BIF	Boulder Growth & Income Fund Inc
BIG	Big Lots
BIO	Bio-Rad Laboratories
BIO.B	Bio Rad Labs Cl B
BIP	Brookfield Infrastructure Partners LP
BIT	Blackrock Multi-Sector Income T
BITA	Bitauto Holdings Ltd
BJ	Bj's Wholesale Club Holdings Inc
BK	Bank of New York Mellon Corp
BK-C	Bank of New York Mellon Corp [Bk/Pc]
BKD	Brookdale Senior Living Inc
BKE	Buckle Inc
BKH	Black Hills Corp
BKI	Black Knight Inc
BKK	Blackrock Muni 2020 Trust
BKN	Blackrock Investment Quality Municipal
BKT	Blackrock Income Trust Inc
BKU	BankUnited Inc
BLD	Topbuild Corp
BLE	Blackrock Muni Income Trust II
BLK	Blackrock
BLL	Ball Corp
BLW	Blackrock Ltd Duration Income Trust
BLX	Banco Latinoamericano DE Comercio
BMA	Banco Macro S.A.
BME	Blackrock Health Sciences Trust
BMI	Badger Meter
BML-G	Bank of America Corp [Bml/Pg]
BML-H	Bank of America Corp [Bml/Ph]
BML-J	Bank of America Corp [Bml/Pj]
BML-L	Bank of America Corp [Bml/Pl]
BMO	Bank of Montreal
BMY	Bristol-Myers Squibb Company
BNED	Barnes & Noble Education Inc C
BNS	Bank of Nova Scotia
BNY	Blackrock New York Muni Trust Inc
BOE	Blackrock Global
BOH	Bank of Hawaii Corp
BOOT	Boot Barn Holdings Inc
BORR	Borr Drilling Ltd
BOX	Box Inc
BP	BP Plc
BPL	Buckeye Partners LP
BPMP	BP Midstream Partners LP
BPT	BP Prudhoe Bay Royalty Trust
BQH	Blackrock New York Muni Trust
BR	Broadridge Financial Solutions Llc
BRBR	Bellring Brands Inc Cl A
BRC	Brady Corp
BRFS	Brf-Brasil Foods S.A.
BRK.A	Berkshire Hathaway Cl A
BRK.B	Berkshire Hathaway Cl B
BRO	Brown & Brown
BRP.U	B Riley Principal Merger Corp [Brpm.U]
BRP.W	B Riley Principal Merger Corp [Brpm/W]
BRPM	B. Riley Principal Merger Corp
BRT	BRT Realty Trust
BRX	Brixmor Property Group Inc
BSA	Brightsphere Investment Group Plc
BSAC	Banco Santander Chile ADR
BSBR	Banco Santander Brasil S.A.
BSD	Blackrock Strategic Muni Trust Inc
BSE	Blackrock New York Muni Income Trust
BSIG	Brightsphere Investment Group Plc
BSL	Blackstone Gso Senior Floating Rate
BSM	Black Stone Minerals LP
BSMX	Grupo Financiero Santander Mexico
BST	Blackrock Science and Technolo
BSTZ	Blackrock Science and Technology Trust II
BSX	Boston Scientific Corp
BTA	Blackrock Long-Term Muni Advantage Trust
BTE	Baytex Energy Corp
BTI	British American Tobacco Industries
BTO	John Hancock Bank and Thrift Fund
BTT	Blackrock Municipal Target Term
BTU	Peabody Energy Corp
BTZ	Blackrock Preferred
BUD	Anheuser-Busch Inbev S.A.
BUI	Blackrock Utility and Infrastr
BURL	Burlington Stores Inc
BV	Brightview Holdings Inc
BVN	Compania Mina Buenaventura S.A.
BW	Babcock & Wilcox Enterprises
BWA	Borgwarner Inc
BWG	Legg Mason Bw Global Income
BWXT	Bwx Technologies Inc
BX	The Blackstone Group LP
BXC	Bluelinx Holdings Inc
BXG	Bluegreen Vacations Corp
BXMT	Blackstone Mortgage Trust Inc Cl A
BXMX	Nuveen Equity Premium
BXP	Boston Properties
BXP-B	Boston Properties Inc [Bxp/Pb]
BXS	Bancorpsouth Inc
BY	Byline Bancorp Inc
BYD	Boyd Gaming Corp
BYM	Blackrock Muni Income Quality Trust
BZH	Beazer Homes USA
BZM	Blackrock Maryland Muni Trust
C	Citigroup Inc
C-J	Citigroup Inc [C/Pj]
C-K	Citigroup Inc [C/Pk]
C-N	Citigroup Cap XiII [C/Pn]
C-S	Citigroup Inc [C/Ps]
CAAP	Corporacion America Airports Sa
CABO	Cable One Inc
CACI	Caci International
CADE	Cadence Bancorp Cl A
CAE	Cae Inc
CAF	Morgan Stanley China A Share Fund Inc
CAG	Conagra Brands Inc
CAH	Cardinal Health
CAI	Cai International
CAI-A	Cai International Inc [Cai/Pa]
CAI-B	Cai International Inc [Cai/Pb]
CAJ	Canon Inc
CAL	Caleres Inc
CALX	Calix Inc
CANG	Cango Inc ADR
CAPL	Crossamerica Partners LP
CARS	Cars.com Inc
CAT	Caterpillar Inc
CATO	Cato Corp
CB	Chubb Ltd
CBB	Cincinnati Bell Inc
CBB-B	Cincinnati Bell Inc [Cbb/Pb]
CBD	Companhia Brasileira DE Distribuicao
CBH	Allianzgi Convertible Income 2024 Target Term Fu
CBL	Cbl & Associates Properties
CBL-D	Cbl & Assoc Pptys Inc [Cbl/Pd]
CBL-E	Cbl & Assoc Pptys Inc [Cbl/Pe]
CBM	Cambrex Corp
CBPX	Continental Building Products
CBRE	CBRE Group Inc
CBS	CBS Corp
CBS.A	CBS Corp Cl A
CBT	Cabot Corp
CBU	Community Bank System
CBZ	Cbiz Inc
CC	Chemours Company
CCC	Clarivate Analytics Plc
CCEP	Coca Cola European Partners
CCH	Collier Creek Holdings Cl A
CCH.U	Collier Creek Holdings
CCH.W	Collier Creek Holdings [Cch/W]
CCI	Crown Castle International Corp
CCI-A	Crown Castle Intl Corp [Cci/Pa]
CCJ	Cameco Corp
CCK	Crown Cork & Seal Company
CCL	Carnival Corp
CCM	Concord Medical Services
CCO	Clear Channel Outdoor Holdings
CCR	Consol Coal Resources LP
CCS	Century Communities Inc
CCU	Compania Cervecerias Unidas S.A.
CCX	Churchill Capital Corp II
CCX.U	Churchill Capital Corp II
CCX.W	Churchill Cap Corp II [Ccx/W]
CCZ	Comcast Corp
CDAY	Ceridian Hcm Holding Inc
CDE	Coeur Mining Inc
CDR	Cedar Shopping Centers Inc
CDR-B	Cedar Realty Trust Inc [Cdr/Pb]
CDR-C	Cedar Realty Trust Inc [Cdr/Pc]
CE	Celanese Corp
CEA	China Eastern Airlines Corp Ltd
CEE	Central Europe and Russia Fund
CEIX	Consol Energy Inc
CEL	Cellcom Israel
CELP	Cypress Energy Partners LP
CEM	Clearbridge Energy MLP Fund Inc
CEN	Center Coast MLP & Infrastructure
CEO	Cnooc Ltd
CEPU	Central Puerto S.A. ADR
CEQ.P	Crestwood Equity Partners LP [Ceqp/P]
CEQP	Crestwood Equity Partners LP
CF	Cf Industries Holdings
CFG	Citizens Financial Group Inc/Ri
CFG-D	RBS Citizens Finl Group Inc [Cfg/Pd]
CFR	Cullen/Frost Bankers
CFR-A	Cullen Frost Bankers [Cfr/Pa]
CFX	Colfax Corp
CFXA	Colfax Corp Tangible Equity Unit
CGA	China Green Agriculture
CGC	Canopy Growth Corp
CHA	China Telecom Corp Ltd
CHAP	Chaparral Energy Inc
CHCT	Community Healthcare Trust Inc
CHD	Church & Dwight Company
CHE	Chemed Inc
CHGG	Chegg Inc
CHH	Choice Hotels International
CHK	Chesapeake Energy Corp
CHK-D	Chesapeake Energy Corp [Chk/Pd]
CHKR	Chesapeake Granite Wash Trust
CHL	China Mobile [Hong Kong] Ltd
CHM-A	Cherry Hill Mtg Invt Corp [Chmi/Pa]
CHM-B	Cherry Hill Mtg Invt Corp [Chmi/Pb]
CHMI	Cherry Hill Mortgage Investmen
CHN	China Fund
CHRA	Charah Solutions Inc
CHS	Chico's Fas
CHT	Chunghwa Telecom Co. Ltd
CHU	China Unicom [Hong Kong] Ltd
CHWY	Chewy Inc
CI	Cigna Corp
CIA	Citizens Inc
CIB	Bancolombia S.A.
CIEN	Ciena Corp
CIF	Colonial Intermediate High
CIG	Comp En DE MN Cemig ADR
CIG.C	Comp En DE MN Cemig ADR Cl C
CII	Blackrock Capital and Income Strategies
CIM	Chimera Investment Corp
CIM-A	Chimera Invt Corp [Cim/Pa]
CIM-B	Chimera Invt Corp [Cim/Pb]
CIM-C	Chimera Invt Corp [Cim/Pc]
CIM-D	Chimera Invt Corp [Cim/Pd]
CINR	Ciner Resources LP
CIO	City Office REIT Inc
CIO-A	City Office REIT Inc [Cio/Pa]
CIR	Circor International
CISN	Cision Ltd
CIT	Cit Group Inc
CJ	C&J Energy Services Inc
CKH	Seacor Smit Inc
CL	Colgate-Palmolive Company
CLB	Core Laboratories N.V.
CLDR	Cloudera Inc
CLDT	Chatham Lodging Trust [Reit]
CLF	Cleveland-Cliffs Inc
CLGX	Corelogic
CLH	Clean Harbors
CLI	Mack-Cali Realty Corp
CLN-B	Colony Cap Inc [Clny/Pb]
CLN-E	Colony Cap Inc [Clny/Pe]
CLN-G	Colony Cap Inc [Clny/Pg]
CLN-H	Colony Cap Inc [Clny/Ph]
CLN-I	Colony Cap Inc [Clny/Pi]
CLN-J	Colony Cap Inc [Clny/Pj]
CLNC	Colony Northstar Credit Real Estate Inc Class
CLNY	Colony Capital Inc
CLPR	Clipper Realty Inc
CLR	Continental Resources
CLS	Celestica Inc
CLW	Clearwater Paper Corp
CLX	Clorox Company
CM	Canadian Imperial Bank of Commerce
CMA	Comerica Inc
CMC	Commercial Metals Company
CMCM	Cheetah Mobile Inc
CMD	Cantel Medical
CMG	Chipotle Mexican Grill
CMI	Cummins Inc
CMO	Capstead Mortgage Corp
CMO-E	Capstead Mtge.Corp [Cmo/Pe]
CMP	Compass Minerals Intl Inc
CMR-B	Costamare Inc [Cmre/Pb]
CMR-C	Costamare Inc [Cmre/Pc]
CMR-D	Costamare Inc [Cmre/Pd]
CMR-E	Costamare Inc [Cmre/Pe]
CMRE	Costamare Inc
CMS	Cms Energy Corp
CMS-B	Consumers Energy Company [Cms/Pb]
CMSA	Cms Energy Corp 5.625% Junior Subordinate
CMSC	Cms Energy Corp
CMSD	Cms Energy Corp 5.875% Junior Subordinate
CMU	Colonial Muni Income Trust
CNA	Cna Financial Corp
CNC	Centene Corp
CNDT	Conduent Inc
CNF	Cnfinance Holdings Ltd ADR
CNHI	CNH Industrial N.V.
CNI	Canadian National Railway
CNK	Cinemark Holdings Inc
CNNE	Cannae Holdings Inc
CNO	Cno Financial Group
CNP	Centerpoint Energy Inc
CNP-B	Centerpoint Energy Inc [Cnp/Pb]
CNQ	Canadian Natural Resources
CNR	Cornerstone Building Brands Inc
CNS	Cohn & Steers Inc
CNX	CNX Resources Corp
CNXM	CNX Midstream Partners LP
CO	Global Cord Blood Corp
COD-A	Compass Div Holdings [Codi/Pa]
COD-B	Compass Div Holdings [Codi/Pb]
CODI	Compass Diversified Holdings
COE	China Online Education Group
COF	Capital One Financial Corp
COF-C	Capital One Financial Corp [Cof/Pc]
COF-D	Capital One Financial Corp [Cof/Pd]
COF-F	Capital One Financial Corp [Cof/Pf]
COF-G	Capital One Financial Corp [Cof/Pg]
COF-H	Capital One Financial Corp [Cof/Ph]
COF-I	Capital One Financial Corp. - Prf Perpetual USD
COF-P	Capital One Financial Corp [Cof/Pp]
COG	Cabot Oil & Gas Corp
COLD	Americold Realty Trust
COO	Cooper Companies
COP	Conocophillips
COR	Coresite Realty Corp
COR-Z	Corenergy Infrastructure TR IN [Corr/Pa]
CORR	Corenergy Infrastructure Trust Inc
COT	Cott Corp
COTY	Coty Inc
CP	Canadian Pacific Railway
CPA	Copa Holdings S.A.
CPAC	Cementos Pacasmayo S.A.A
CPB	Campbell Soup Company
CPE	Callon Petroleum Company
CPF	Central Pacific Financial Company
CPG	Crescent Pt Energy
CPK	Chesapeake Utilities Corp
CPL	Cpfl Energia S.A.
CPLG	Corepoint Lodging Inc
CPRI	Capri Holdings Ltd
CPS	Cooper Std Hldg Inc
CPT	Camden Property Trust
CR	Crane Company
CRC	California Resources Corp
CRCM	Care.com Inc
CRD.A	Crawford Co. Cl A
CRD.B	Crawford Co. Cl B
CRH	CRH Plc
CRI	Carter's Inc
CRK	Comstock Resources
CRL	Charles River Laboratories Intl
CRM	Salesforce.com Inc
CRR	Carbo Ceramics
CRS	Carpenter Technology Corp
CRT	Cross Timbers Royalty Trust
CRY	Cryolife
CS	Credit Suisse Group
CSL	Carlisle Companies Inc
CSLT	Castlight Health Inc
CSS	Css Industries
CSTM	Constellium N.V.
CSU	Capital Senior Living Corp
CSV	Carriage Services
CTA-A	Du Pont[E.I.]De Nemours & Co. [Cta/Pa]
CTA-B	Du Pont[E.I.]De Nemours & Co. [Cta/Pb]
CTAA	Qwest Corp
CTB	Cooper Tire & Rubber Company
CTBB	Qwest Corp
CTDD	Qwest Corp 6.75% Notes Due 2057
CTK	Cootek [Cayman] Inc
CTL	Centurylink
CTLT	Catalent Inc
CTR	Clearbridge Energy MLP Fund IN
CTRA	Contura Energy Inc
CTS	Cts Corp
CTST	Canntrust Holdings Inc
CTT	Catchmark Timber Trust Inc
CTV	Qwest Corp
CTVA	Corteva Inc
CTY	Qwest Corp
CTZ	Qwest Corp 6.625% Notes
CUB	Cubic Corp
CUB-C	Customers Bancorp Inc [Cubi/Pc]
CUB-D	Customers Bancorp Inc [Cubi/Pd]
CUB-E	Customers Bancorp Inc [Cubi/Pe]
CUB-F	Customers Bancorp Inc [Cubi/Pf]
CUBE	Cubesmart
CUBI	Customers Bancorp
CUK	Carnival Plc ADR
CULP	Culp Inc
CURO	Curo Group Holdings Corp
CUZ	Cousins Properties Inc
CVA	Covanta Holding Corp
CVE	Cenovus Energy Inc
CVEO	Civeo Corp
CVI	Cvr Energy Inc
CVIA	Covia Holdings Corp
CVNA	Carvana Co. Cl A
CVS	CVS Corp
CVX	Chevron Corp
CW	Curtiss-Wright Corp
CWE.A	Clearway Energy Inc Cl A
CWEN	Clearway Energy Inc Cl C
CWH	Camping World Holdings Inc
CWK	Cushman & Wakefield Plc
CWT	California Water Service Group Holding
CX	Cemex S.A.B. DE C.V.
CXE	Colonial High Income Muni Trust
CXH	Colonial Investment Grade Muni Trust
CXO	Concho Resources Inc
CXP	Columbia Property Trust Inc
CXW	Corecivic Inc
CYD	China Yuchai International
CYH	Community Health Systems
CZZ	Cosan Ltd
D	Dominion Resources
DAC	Danaos Corp
DAL	Delta Air Lines Inc
DAN	Dana Inc
DAR	Darling International Inc
DAVA	Endava Plc
DB	Deutsche Bank Ag
DBD	Diebold Nixdorf Inc
DBI	Designer Brands Inc
DBL	Doubleline Opportunistic Credi
DCF	Dreyfus Alcentra Global Credit Income 2024 Targe
DCI	Donaldson Company
DCO	Ducommun Inc
DCP	Dcp Midstream LP
DCP-B	Dcp Midstream LP [Dcp/Pb]
DCP-C	Dcp Midstream LP [Dcp/Pc]
DCUE	Dominion Energy Inc 2019 Series A
DD	Du Pont De.Nemours Inc
DDD	3D Systems Corp
DDF	Delaware Dividend & Income
DDS	Dillard's
DDT	Dillard's
DE	Deere & Company
DEA	Easterly Government Properties
DECK	Deckers Outdoor Corp
DEI	Douglas Emmett
DELL	Dell Technologies Inc
DEO	Diageo Plc
DESP	Despegar.com Corp
DEX	Delaware Enhanced Global Dividend
DF	Dean Foods Company
DFIN	Donnelly Financial Solutions Inc
DFP	Flaherty & Crumrine Dynamic
DFS	Discover Financial Services
DG	Dollar General Corp
DGX	Quest Diagnostics Inc
DHF	Dreyfus High Yield Strategies Fund
DHI	D.R. Horton
DHR	Danaher Corp
DHR-A	Danaher Corp [Dhr/Pa]
DHT	Dht Holdings
DHX	Dice Holdings
DIAX	Nuveen Dow
DIN	Dineequity Inc
DIS	Walt Disney Company
DK	Delek US Holdings
DKL	Delek Logistics Partners LP
DKS	Dick's Sporting Goods Inc
DKT	Deutsch Bk Contingent Cap TR V
DL	China Distance Education Holdings
DLB	Dolby Laboratories
DLN-A	Dynagas Lng Partners LP [Dlng/Pa]
DLN-B	Dynagas Lng Partners LP [Dlng/Pb]
DLNG	Dynagas Lng Partners LP
DLPH	Delphi Technologies Plc
DLR	Digital Realty Trust
DLR-C	Digital Rlty TR Inc [Dlr/Pc]
DLR-G	Digital Rlty TR Inc [Dlr/Pg]
DLR-I	Digital Rlty TR Inc [Dlr/Pi]
DLR-J	Digital Rlty TR Inc [Dlr/Pj]
DLR-K	Digital Rlty TR Inc [Dlr/Pk]
DLR-L	Digital Realty Trust Inc 5.20% Prf Perpetual USD
DLX	Deluxe Corp
DMB	Dreyfus Municipal Bond Infrastr
DMO	Western Asset Mortgage Defined Opp
DNI	Chartwell Dividend & Income Fund
DNOW	Now Inc
DNP	Duff & Phelps Utilities Income
DNR	Denbury Resources
DO	Diamond Offshore Drilling
DOC	Physicians Realty Trust
DOOR	Masonite Wrldwde Hld
DOV	Dover Corp
DOW	Dow Inc
DPG	Duff & Phelps Global Utility
DPLO	Diplomat Pharmacy Inc
DPZ	Domino's Pizza Inc
DQ	Daqo New Energy
DRD	Drdgold Ltd
DRE	Duke Realty Corp
DRH	Diamondrock Hospitality Company
DRI	Darden Restaurants
DRQ	Dril-Quip
DRUA	Dominion Resources Inc
DS	Drive Shack Inc
DS-B	Drive Shack Inc [Ds/Pb]
DS-C	Drive Shack Inc [Ds/Pc]
DS-D	Drive Shack Inc [Ds/Pd]
DSE	Duff & Phelps Select Energy ML
DSL	Doubleline Income Solutions Fun
DSM	Dreyfus Strategic Muni Bond Fund
DSSI	Diamond S Shipping Inc
DSU	Blackrock Debt Strategies Fund
DSX	Diana Shipping Inc
DSX-B	Diana Shipping Inc [Dsx/Pb]
DT	Dynatrace Inc
DTE	Dte Energy Company
DTF	Duff & Phelps Utilities Tax-Free Income
DTJ	Dte Energy Company 2016 Series
DTL.P	Brookfield Dtla Fd Office TR I [Dtla/P]
DTQ	Dte Energy Company Sub Deb 62
DTV	Dte Energy Company Corp Unit
DTW	Dte Energy Company 2017 Series E 5.25% Jr
DTY	Dignity Plc
DUC	Duff & Phelps Utility & Corporate Trust
DUK	Duke Energy Corp
DUK-A	Duke Energy Corp [Duk/Pa]
DUKB	Duke Energy Corp 5.625%
DUKH	Duke Energy Corp 5.125%
DVA	Davita Healthcare Partners Inc
DVD	Dover Downs Entertainment
DVN	Devon Energy Corp
DX	Dynex Capital
DX-A	Dynex Cap Inc [Dx/Pa]
DX-B	Dynex Cap Inc [Dx/Pb]
DXB	Deutsche Bk Contingent Cap TR
DXC	Dxc Technology Company
DY	Dycom Industries
E	Eni S.P.A.
EAB	First Mortgage Bonds
EAE	Entergy Arkansas Inc
EAF	Graftech International Ltd
EAI	Entergy Arkansas Inc
EARN	Ellington Residential Mortgage
EAT	Brinker International
EB	Eventbrite Inc
EBF	Ennis Inc
EBR	Centrais Electricas Brazil
EBR.B	Centrais Eletricas Brasileiras ADR
EBS	Emergent Biosolutions
EC	Ecopetrol S.A.
ECA	Encana Corp
ECC	Eagle Point Credit Co. Inc
ECCA	Eagle Point Credit Company Inc
ECCB	Eagle Point Credit Company Inc
ECCX	Eagle Point Credit Company Inc 6.6875% Notes Du
ECCY	Eagle Point Credit Company Inc
ECL	Ecolab Inc
ECOM	Channeladvisor Corp
ECT	Eca Marcellus Trust
ED	Consolidated Edison Company of New York
EDD	Emerging Markets Domestic Debt Fund
EDF	Stone Harbor Emerging Markets
EDI	Stone Harbor Emerging Markets
EDN	Empresa Distribuidora Y Comercializadora
EDU	New Oriental Education & Technology Group
EE	El Paso Electric Company
EEA	European Equity Fund
EEX	Emerald Expositions Events Inc
EFC	Ellington Financial Llc
EFF	Eaton Vance Floating-Rate Inco
EFL	Eaton Vance Floating-Rate 2022 Target Term Trust
EFR	Eaton Vance Senior Floating-Rate Fund
EFT	Eaton Vance Floating Rate Income Trust
EFX	Equifax Inc
EGF	Blackrock Enhanced Government Fund
EGHT	8X8 Inc
EGIF	Eagle Growth and Income Opportunity
EGO	Eldorado Gold Corp
EGP	Eastgroup Properties
EGY	Vaalco Energy Inc
EHC	Encompass Health Corp
EHI	Western Asset Global High
EHT	Eaton Vance High Income 2021 Ta
EIC	Eagle Point Income Company Inc
EIG	Employers Holdings Inc
EIX	Edison International
EL	Estee Lauder Companies
ELAN	Elanco Animal Health Inc
ELC	Entergy Louisiana Llc
ELF	E.L.F. Beauty Inc
ELJ	Entergy Louisiana Llc
ELP	Companhia Paranaense DE Energia
ELS	Equity Lifestyle Properties
ELU	Entergy Louisiana Llc First M
ELVT	Elevate Credit Inc
ELY	Callaway Golf Company
EMD	Western Asset Emerging Market Debt Fund Inc
EME	Emcor Group
EMF	Templeton Emerging Markets Fund
EMN	Eastman Chemical Company
EMO	Clearbridge Energy MLP Opportu
EMP	Entergy Mississippi Inc 4.9% Bonds
EMR	Emerson Electric Company
ENB	Enbridge Inc
ENBA	Enbridge Inc 6.375% Fixed-To-Floating Rate
ENBL	Enable Midstream Partners LP
ENIA	Enersis Americas S.A. American
ENIC	Enersis Chile S.A. ADR
ENJ	Entergy New Orleans Inc
ENLC	Enlink Midstream Llc
ENO	Entergy New Orleans Incfirst
ENR	Energizer Holdings Inc
ENR-A	Energizer Holdings Inc [Enr/Pa]
ENS	Enersys Inc
ENV	Envestnet Inc
ENVA	Enova International Inc
ENZ	Enzo Biochem
EOD	Wells Fargo Global Dividend Opportunity
EOG	Eog Resources
EOI	Eaton Vance Enhance Equity
EOS	Eaton Vance Enhanced Equity II
EOT	Eaton Vance Muni Income Trust
EP-C	El Paso Energy Capital [Ep/Pc]
EPAC	Actuant Corp
EPAM	Epam Systems Inc
EPC	Edgewell Personal Care
EPD	Enterprise Products Partners LP
EPR	Entertainment Properties Trust
EPR-C	Epr Pptys [Epr/Pc]
EPR-E	Epr Pptys [Epr/Pe]
EPR-G	Epr Pptys [Epr/Pg]
EPRT	Essential Properties Realty Trust Inc
EQC	Equity Commonwealth
EQC-D	Equity Comwlth [Eqc/Pd]
EQH	Axa Equitable Holdings Inc
EQM	Eqm Midstream Partners LP
EQNR	Equinor ASA
EQR	Equity Residential
EQS	Equus Total Return
EQT	Eqt Corp
ERA	Era Group Inc
ERF	Enerplus Corp
ERJ	Embraer-Empresa Brasileira DE Aeronautica
EROS	Eros International Plc
ES	Eversource Energy
ESE	Esco Technologies Inc
ESI	Element Solutions Inc
ESNT	Essent Group Ltd
ESRT	Empire State Realty Trust Inc
ESS	Essex Property Trust
ESTC	Elastic N.V.
ESTE	Earthstone Energy
ET	Energy Transfer LP
ETB	Eaton Vance Tax-Managed Buy-Write
ETG	Eaton Vance Tax-Advantaged Global Dividend
ETH	Ethan Allen Interiors Inc
ETI.P	Entergy Texas Inc 5.375% Series A Preferred Stoc
ETJ	Eaton Vance Risk-Managed Diversified Equity
ETM	Entercom Communications Corp
ETN	Eaton Corp
ETO	Eaton Vance Tax-Advantage Global Dividend Opp
ETP-C	Energy Transfer Operating L P [Etp/Pc]
ETP-D	Energy Transfer Operating L P [Etp/Pd]
ETP-E	Energy Transfer Operating L P [Etp/Pe]
ETR	Entergy Corp
ETRN	Equitrans Midstream Corp
ETV	Eaton Vance Corp
ETW	Eaton Vance Corp
ETX	Eaton Vance Municipal Income T
ETY	Eaton Vance Tax-Managed Diversified Equity
EURN	Euronav NV
EV	Eaton Vance Corp
EVA	Enviva Partners LP
EVC	Entravision Communications Corp
EVF	Eaton Vance Senior Income Trust
EVG	Eaton Vance Short Diversified
EVH	Evolent Health Inc Cl A Com
EVN	Eaton Vance Muni Income Trust
EVR	Evercore Partners Inc
EVRG	Evergy Inc
EVRI	Everi Holdings Inc
EVT	Eaton Vance Tax Advantaged Dividend
EVTC	Evertec Inc
EW	Edwards Lifesciences Corp
EXC	Exelon Corp
EXD	Eaton Vance Tax-Advantaged Bond
EXG	Eaton Vance Tax-Managed Global Diversified Equit
EXK	Endeavour Silver Corp
EXP	Eagle Materials Inc
EXPR	Express Inc
EXR	Extra Space Storage Inc
EXTN	Exterran Corp
EZT	First Mortgage Bonds
F	Ford Motor Company
F-B	Ford Mtr Co. Del [F/Pb]
FAF	First American Corp
FAM	First Trust/Aberdeen Global Opportunity
FBC	Flagstar Bancorp
FBHS	Fortune Brands Home & Security
FBK	Fb Financial Corp
FBM	Foundation Building Materials Inc
FBP	First Bancorp
FC	Franklin Covey Company
FCAU	Fiat Chrysler Automobiles N.V.
FCF	First Commonwealth Financial Corp
FCN	Fti Consulting
FCPT	Four Corners Property Trust IN
FCT	Senior Floating Rate II
FCX	Freeport-Mcmoran Inc
FDEU	First Trust Dynamic Europe Equi
FDP	Fresh Del Monte Produce
FDS	Factset Research Systems Inc
FDX	Fedex Corp
FE	Firstenergy Corp
FEDU	Four Seasons Education [Cayman] Inc
FEI	First Trust MLP and Energy Inc
FELP	Foresight Energy LP
FENG	Phoenix New Media Ltd
FEO	First Trust/Aberdeen Emerging Opportunity Fund
FET	Forum Energy Technologies Inc
FF	Futurefuel Corp
FFA	First Trust Enhanced Equity Income Fund
FFC	Flaherty Crumrine/Claymore Preferred Securities
FFG	Fbl Financial Group
FG	Fgl Holdings
FG.W	Fgl Hldgs [Fg/W]
FGB	Specialty Finance and Financial Fund
FGP	Ferrellgas Partners LP
FHN	First Horizon National Corp
FHN-A	First Horizon National Corp [Fhn/Pa]
FI	Frank's International N.V.
FICO	Fair Isaac and Company Inc
FIF	First Trust Energy Infrastruct
FII	Federated Investors
FINS	Angel Oak Financial Strategies Income Term Trust
FIS	Fidelity National Information Services
FIT	Fitbit Inc
FIV	First Trust Senior Floating Rate 2022 Target Ter
FIX	Comfort Systems USA
FL	Footlocker Inc
FLC	Flaherty & Crumrine/Claymore Total Return
FLNG	Flex Lng Ltd
FLO	Flowers Foods
FLOW	SPX Flow Inc
FLR	Fluor Corp
FLS	Flowserve Corp
FLT	Fleetcor Technologies
FLY	Fly Leasing Ltd
FMC	FMC Corp
FMN	Federated Premier Muni
FMO	Fiduciary/Claymore MLP Opportunity Fund
FMS	Fresenius Medical Care Corp
FMX	Fomento Economico Mexicano S.A.B. DE C.V.
FMY	First Trust/Fidac Mortgage Income Fund
FN	Fabrinet
FNB	F.N.B. Corp
FNB-E	Fnb Corp Florida [Fnb/Pe]
FND	Floor & Decor Holdings Inc
FNF	Fidelity National Financial
FNV	Franco Nev Corp
FOE	Ferro Corp
FOF	Cohen & Steers Closed-End Opportunity Fund
FOR	Forestar Group Inc
FPA.U	Far Pt Acquisition Corp [Fpac.U]
FPA.W	Far Point Acquisition Cl A WT
FPAC	Far Point Acquisition Corp Cl A
FPF	First Trust Intermediate Durat
FPH	Five Point Holdings Llc Cl A
FPI	Farmland Partners Inc
FPI-B	Farmland Partners Inc [Fpi/Pb]
FPL	First Trust New Opportunities M
FR	First Industrial Realty Trust
FRA	Blackrock Floating Rate Income Fund
FRAC	Keane Group Inc
FRC	First Republic Bank
FRC-D	First Republic Bank San Francisco [Frc/Pd]
FRC-F	First Republic Bank San Francisco [Frc/Pf]
FRC-G	First Republic Bank San Francisco [Frc/Pg]
FRC-H	First Republic Bank San Francisco [Frc/Ph]
FRC-I	First Rep Bk San Francisco [Frc/Pi]
FRO	Frontline Ltd
FRT	Federal Realty Investment Trust
FRT-C	Federal Realty Invt TR [Frt/Pc]
FSB	Franklin Financial Network Inc
FSD	High Income Long Short Fund
FSK	FS KKR Capital Corp
FSLY	Fastly Inc
FSM	Fortuna Silver Mines
FSS	Federal Signal Corp
FT	Franklin Universal Trust
FTA-A	Fortress Transportation and Infrastructure Inves
FTAI	Fortress Transportation & Infra
FTCH	Farfetch Ltd Cl A
FTI	Technipfmc Plc
FTK	Flotek Industries
FTS	Fortis Inc
FTSI	Fts International Inc
FTV	Fortive Corp
FTV-A	Fortive Corp [Ftv/Pa]
FUL	H. B. Fuller Company
FUN	Cedar Fair LP
FVRR	Fiverr International Ltd
G	Genpact Ltd
GAB	Gabelli Equity Trust
GAB-D	Gabelli Equity Trust Inc [Gab/Pd]
GAB-G	Gabelli Equity Trust Inc [Gab/Pg]
GAB-H	Gabelli Equity Trust Inc [Gab/Ph]
GAB-J	Gabelli Equity Trust Inc [Gab/Pj]
GAM	General American Investors
GAM-B	General Amern Invs Inc [Gam/Pb]
GATX	GATX Corp
GBAB	Guggenheim Build America Bonds
GBL	Gamco Investors
GBX	Greenbrier Companies
GCAP	Gain Capital Holdings
GCI	Gannett Co. Inc
GCO	Genesco Inc
GCP	Gcp Applied Technologies Inc C
GCV	Gabelli Convertible and Income Securities
GCV-B	Gabelli Conv&Incom Secs Fd Inc [Gcv/Pb]
GD	General Dynamics Corp
GDDY	Godaddy Inc
GDI	Gardner Denver Holdings Inc
GDL	The Gdl Fund
GDL-C	Gdl Fund [Gdl/Pc]
GDO	Western Asset Global Corporate Defined
GDOT	Green Dot Corp
GDV	Gabelli Dividend
GDV-A	Gabelli Dividend & Income Trust [Gdv/Pa]
GDV-D	Gabelli Dividend & Income Trust [Gdv/Pd]
GDV-G	Gabelli Dividend & Income Trust [Gdv/Pg]
GDV-H	Gabelli Dividend & Income Trust [Gdv/Ph]
GDV.P	Gabelli Divd & Income TR [Gdv/R]
GE	General Electric Company
GEF	Greif Bros. Corp
GEF.B	Greif Bros. Corp Cl B
GEL	Genesis Energy LP
GEN	Genesis Healthcare Inc
GEO	Geo Group Inc
GER	Goldman Sachs MLP Energy Renai
GES	Guess Inc
GF	New Germany Fund
GFF	Griffon Corp
GFI	Gold Fields Ltd
GFY	Western Asset Variable Rate Strategic
GGB	Gerdau S.A.
GGG	Graco Inc
GGM	Guggenheim Credit Allocation F
GGT	Gabelli Global Multi-Media Trust
GGT-B	Gabelli Multimedia Trust Inc [Ggt/Pb]
GGT-E	Gabelli Multimedia Trust Inc [Ggt/Pe]
GGZ	Gabelli Global Small and Mid CA
GGZ-A	Gabelli Global Small & Mid Cap Val [Ggz/Pa]
GHC	Graham Holdings Company
GHG	Greentree Hospitality Group Ltd ADR
GHL	Greenhill & Co. Inc
GHM	Graham Corp
GHY	Prudential Global Short Durati
GIB	CGI Group
GIG	Gigcapital Inc
GIG.P	Gigcapital Inc [Gig/R]
GIG.U	Gigcapital Inc
GIG.W	Gigcapital Inc [Gig/W]
GIL	Gildan Activewear
GIM	Templeton Global
GIS	General Mills
GIX	Gigcapital2 Inc
GIX.P	Gigcapital2 Inc [Gix/R]
GIX.U	Gigcapital2 Inc
GIX.W	Gigcapital2 Inc [Gix/W]
GJH	Strats Sm Trust For United States Cellular Corp
GJO	Strats Sm Trust For Wal-Mart Stores Inc Securiti
GJP	Strats Sm Trust For Dominion Resources Inc Secur
GJR	Strats Sm Trust For The Procter & Gamble Co. Sec
GJS	Strats Sm Trust For Goldman Sachs Group Securiti
GJT	Strats Sm Trust For Allstate Corp Securities Ser
GJV	Strats Sm Trust For News Corp Securities Series
GKOS	Glaukos Corp
GL	Globe Life Inc
GL-C	Globe Life Inc [Gl/Pc]
GLO-A	Gaslog Partners LP [Glop/Pa]
GLO-B	Gaslog Partners LP [Glop/Pb]
GLO-C	Gaslog Partners LP [Glop/Pc]
GLO-G	Gaslog Ltd [Glog/Pa]
GLOB	Globant S.A.
GLOG	Gaslog Ltd
GLOP	Gaslog Partners LP
GLP	Global Partners LP
GLP-A	Global Partners LP [Glp/Pa]
GLT	Glatfelter
GLW	Corning Inc
GM	General Motors Company
GME	Gamestop Corp
GMED	Globus Medical Inc
GMR-A	Global Med REIT Inc [Gmre/Pa]
GMRE	Global Medical REIT Inc
GMS	Gms Inc
GMTA	GATX Corp 5.625% Senior
GMZ	Goldman Sachs MLP Income Oppor
GNC	GNC Holdings Inc
GNE	Genie Energy Ltd Cl B
GNE-A	Genie Energy Ltd [Gne/Pa]
GNK	Genco Shipping & Trading Ltd
GNL	Global Net Lease Inc
GNL-A	Global Net Lease Inc [Gnl/Pa]
GNRC	Generac Holdings Inc
GNT	Gabelli Natural Resources Gold
GNT-A	Gamco Nat Res Gold & Income TR [Gnt/Pa]
GNW	Genworth Financial Inc
GOF	Claymore/Guggenheim Strategic Fund
GOL	Gol Linhas Aereas Inteligentes S.A.
GOLD	Barrick Gold Corp
GOLF	Acushnet Holdings Corp
GOOS	Canada Goose Holdings Inc Subordinate Voting Sh
GPC	Genuine Parts Company
GPI	Group 1 Automotive
GPJA	Georgia Power Company Series 2017A 5.00% Jr
GPK	Graphic Packaging Holding Company
GPM	Guggenheim Enhanced Equity
GPMT	Granite Point Mortgage Trust Inc
GPN	Global Payments Inc
GPRK	Geopark Hldgs Lmtd
GPS	Gap Inc
GPX	Gp Strategies Corp
GRA	W.R. Grace & Company
GRA.U	Graf Indl Corp [Graf.U]
GRA.W	Graf Indl Corp [Graf/W]
GRAF	Graf Industrial Corp
GRAM	Grana Y Montero S.A.A.
GRC	Gorman-Rupp Company
GRP.U	Granite Real Estate Invt TR
GRUB	Grubhub Inc
GRX	The Gabelli Healthcare & Wellness Trust
GRX-A	Gabelli Healthcare & Wellness TR [Grx/Pa]
GRX-B	Gabelli Healthcare & Wellness TR [Grx/Pb]
GS	Goldman Sachs Group
GS-A	Goldman Sachs Group Inc [Gs/Pa]
GS-C	Goldman Sachs Group Inc [Gs/Pc]
GS-D	Goldman Sachs Group Inc [Gs/Pd]
GS-J	Goldman Sachs Group Inc [Gs/Pj]
GS-K	Goldman Sachs Group Inc [Gs/Pk]
GS-N	Goldman Sachs Group Inc [Gs/Pn]
GSA.U	GS Acquisition Hldgs Corp [Gsah.U]
GSA.W	GS Acquisition Hldgs Corp [Gsah/W]
GSAH	GS Acquisition Holdings Corp Cl A
GSBD	Goldman Sachs Bdc Inc
GSH	Guangshen Railway
GSK	Glaxosmithkline Plc
GSL	Global Ship Lease Inc
GSL-B	Global Ship Lease Inc [Gsl/Pb]
GSX	Gsx Techedu Inc ADR
GTES	Gates Industrial Corp Plc
GTN	Gray Television
GTN.A	Gray Television Inc Cl A
GTS	Triple-S Management Corp
GTT	Global Telcom & Technology Inc
GTX	Garrett Motion Inc
GTY	Getty Realty Corp
GUT	Gabelli Utility Trust
GUT-A	Gabelli Utility Trust [Gut/Pa]
GUT-C	Gabelli Utility Trust [Gut/Pc]
GVA	Granite Construction Inc
GWB	Great Western Bancorp Inc
GWR	Genesee & Wyoming
GWRE	Guidewire Software Inc
GWW	W.W. Grainger
GYB	Cabco Series 2004-101 Trust
GYC	Corporate Asset Backed Corp Cabco
H	Hyatt Hotels Corp
HAE	Haemonetics Corp
HAL	Halliburton Company
HASI	Hannon Armstrong Sustainable IN
HBB	Hamilton Beach Brands Holding Company Cl A
HBI	Hanesbrands Inc
HBM	Hudbay Minerals Inc
HCA	Hca Holdings Inc
HCC	Warrior Met Coal Inc
HCFT	Hunt Companies Finance Trust Inc
HCHC	Hc2 Holdings Inc
HCI	Homeowners Choice
HCP	HCP Inc
HCR	Hi-Crush Inc
HCXY	Hercules Capital Inc 6.25% Notes Due 2033
HCXZ	Hercules Capital Inc 5.25% Notes Due 2025
HD	Home Depot
HDB	Hdfc Bank Ltd
HE	Hawaiian Electric Industries
HEI	Heico Corp
HEI.A	Heico Cp Cl A
HEP	Holly Energy Partners LP
HEQ	John Hancock Hedged Eqty & Inc
HES	Hess Corp
HESM	Hess Midstream Partners LP
HEXO	Hexo Corp
HFC	Hollyfrontier Corp
HFR-A	Highland Income Fund [Hfro/Pa]
HFRO	Highland Floating Rate Opportunities Fund
HGH	The Hartford Financial Srvcs G
HGLB	Highland Global Allocation Fund
HGV	Hilton Grand Vacations Inc
HHC	Howard Hughes Corp
HHS	Harte-Hanks
HI	Hillenbrand Inc
HIE	Miller/Howard High Income Eqty
HIG	Hartford Financial Services Group
HIG-G	Hartford Financial Services Grp Inc [Hig/Pg]
HII	Huntington Ingalls Industries
HIL	Hill International Inc
HIO	Western Asset High
HIW	Highwoods Properties
HIX	Western Asset High Income Fund II Inc
HJV	MS S.A.C. Saturns Ge Series 2002-14
HKIB	Amtd International Inc
HL	Hecla Mining Company
HL-B	Hecla Mining Co. [Hl/Pb]
HLF	Herbalife Ltd
HLI	Houlihan Lokey
HLT	Hilton Inc
HLX	Helix Energy Solutions Group
HMC	Honda Motor Company
HMI	Huami Corp ADR
HML-A	Hoegh Lng Partners LP [Hmlp/Pa]
HMLP	Hoegh Lng Partners LP
HMN	Horace Mann Educators Corp
HMY	Harmony Gold Mining Co. Ltd
HNGR	Hanger Inc
HNI	Hon Industries Inc
HNP	Huaneng Power Intl
HOG	Harley-Davidson Inc
HOME	At Home Group Inc
HON	Honeywell International Inc
HOS	Hornbeck Offshore Services
HOV	Hovnanian Enterprises Inc
HP	Helmerich & Payne
HPE	Hewlett Packard Enterprise Comp
HPF	John Hancock Pfd II
HPI	John Hancock Preferred
HPP	Hudson Pacific Properties
HPQ	Hewlett-Packard Company
HPR	Highpoint Resources Corp
HPS	John Hancock Preferred Income Fund III
HQH	Tekla Healthcare Investors
HQL	Tekla Life Sciences Investors
HR	Healthcare Realty Trust Inc
HRB	H&R Block
HRC	Hill-Rom Holdings Inc
HRI	Herc Holdings Inc
HRL	Hormel Foods Corp
HRTG	Heritage Insurance Holdings
HSB-A	HSBC Hldgs Plc [Hsbc/Pa]
HSBC	HSBC Holdings Plc
HSC	Harsco Corp
HST	Host Marriott Financial Trust
HSY	Hershey Foods Corp
HT	Hersha Hospitality Trust
HT-C	Hersha Hospitality TR [Ht/Pc]
HT-D	Hersha Hospitality TR [Ht/Pd]
HT-E	Hersha Hospitality TR [Ht/Pe]
HTA	Healthcare Trust of America
HTD	John Hancock Tax Advantaged Dividend
HTFA	Horizon Technology Finance 6.25% Notes Due 2022
HTGC	Hercules Technology Growth Capital
HTH	Hilltop Holdings Inc
HTY	John Hancock Tax-Advantaged Global
HTZ	Hertz Global Holdings Inc
HUBB	Hubbell Inc B
HUBS	Hubspot Inc
HUD	Hudson Ltd Cl A
HUM	Humana Inc
HUN	Huntsman Corp
HUYA	Huya Inc
HVT	Haverty Furniture Companies
HVT.A	Haverty Furn Cl A SC
HXL	Hexcel Corp
HY	Hyster-Yale Materials Handling
HYB	New America High
HYI	Western Asset High Yield Defined
HYT	Blackrock High Yield Fund Vi Inc
HZN	Horizon Global Corp Comm
HZO	Marinemax Inc
I	Intelsat S.A.
IAA	Iaa Inc
IAE	VOYA Asia Pacific High Dividend Equity
IAG	Iamgold Corp
IBA	Industrias Bachoco S.A. DE C.V.
IBM	International Business Machines
IBN	Icici Bank Ltd
IBP	Installed Building Products
ICD	Independence Contract Drilling Inc
ICE	Intercontinental Exchange
ICL	Israel Chemicals Ltd
IDA	Idacorp Inc
IDE	VOYA Infrastructure Industrial
IDT	IDT Corp
IEX	Idex Corp
IFF	International Flavors & Fragrances
IFFT	International Flavors & Fragrances Inc
IFN	India Fund
IFS	Intercorp Financial Services Inc
IGA	VOYA Global Advantage and Premium
IGD	VOYA Global Equity Dividend and Premium
IGI	Western Asset Investment Grade Defined
IGR	VOYA Clarion Global Real Estate
IGT	International Game Technology
IHC	Independence Holding Company
IHD	VOYA Emerging Markets High Dividend
IHG	Intercontinental Hotels Group
IHIT	Invesco High Income 2023 Target Term Fund
IHTA	Invesco High Income 2024 Target Term Fund
IID	VOYA International High Dividend Equity
IIF	Morgan Stanley India Investment Fund Inc
IIM	Invesco Insured Muni Income Trust
IIP-A	Innovative Indl Pptys Inc [Iipr/Pa]
IIPR	Innovative Industrial Properties
IMAX	Imax Corp
INB	Cohen & Steers Global Income Builder
INF	Brookfield Global Listed Infra
INFO	IHS Markit Ltd
INFY	Infosys Ltd
ING	ING Groep N.V. ADR
INGR	Ingredion Inc
INN	Summit Hotel Properties
INN-D	Summit Hotel Pptys Inc [Inn/Pd]
INN-E	Summit Hotel Pptys Inc [Inn/Pe]
INS-A	International Seaways Inc [Insw/Pa]
INSI	Insight Select Income Fund
INSP	Inspire Medical Systems Inc
INST	Instructure Inc
INSW	International Seaways Inc
INT	World Fuel Services Corp
INVH	Invitation Homes Inc
INXN	Interxion Holding N.V.
IO	ION Geophysical Corp
IP	International Paper Company
IPG	Interpublic Group of Companies
IPHI	Inphi Corp
IPI	Intrepid Potash Inc
IPO.U	Social Cap Hedosophia Hldgs Co. [Ipoa.U]
IPO.W	Social Cap Hedosophia Hldgs Co. [Ipoa/W]
IPOA	Social Capital Hedosophia Holdings Corp
IQI	Invesco Quality Muni Income Trust
IQV	Iqvia Holdings Inc
IR	Ingersoll-Rand Plc [Ireland]
IRE-C	Investors Real Estate TR [Iret/Pc]
IRET	Investors Real Estate Trust
IRL	Irish Investment Fund
IRM	Iron Mountain Inc
IRR	VOYA Risk Managed Natural Resources Fund
IRS	Irsa Inversiones Y Representaciones S.A.
IRT	Independence Realty Trust Inc
ISD	Prudential Short Duration High
ISG	VOYA Group N.V.
IT	Gartner Inc
ITCB	Itau Corpbanca
ITGR	Integer Holdings Corp
ITT	ITT Inc
ITUB	Itau Unibanco Banco Holding S.A.
ITW	Illinois Tool Works Inc
IVC	Invacare Corp
IVH	Ivy High Income Opportunities
IVR	Invesco Mortgage Capital Inc
IVR-A	Invesco Mortgage Capital Inc [Ivr/Pa]
IVR-B	Invesco Mortgage Capital Inc [Ivr/Pb]
IVR-C	Invesco Mortgage Capital Inc [Ivr/Pc]
IVZ	Invesco Plc
IX	Orix Corp ADR
JAG	Jagged Peak Energy Inc
JAX	J. Alexander's Holdings Inc C
JBGS	Jbg Smith Properties
JBK	Lehman Abs Corp
JBL	Jabil Circuit
JBN	Select Asset Inc
JBR	Select Asset Inc
JBT	John Bean Technologies Corp
JCA-B	Jernigan Cap Inc [Jcap/Pb]
JCAP	Jernigan Capital Inc
JCE	Nuveen Core Equity Alpha Fund
JCI	Johnson Controls Intl
JCO	Nuveen Credit Opportunities 2022 Target Term Fun
JCP	J.C. Penney Company Inc
JDD	Nuveen Diversified Dividend and
JE	Just Energy Group Inc
JE-A	Just Energy Group Inc [Je/Pa]
JEC	Jacobs Engineering Group Inc
JEF	Jefferies Financial Group Inc
JELD	Jeld-Wen Holding Inc
JEMD	Nuveen Emerging Markets Debt 2022 Target Term Fu
JEQ	Japan Equity Fund
JFR	Nuveen Floating Rate
JGH	Nuveen Global High Income Fund
JHAA	Nuveen High Income 2023 Target Term Fund
JHB	Nuveen High Income November 2021 Target Term Fun
JHD	Nuveen High Income December 2019 Target Term Fun
JHG	Janus Henderson Group Plc
JHI	John Hancock Investors Trust
JHS	John Hancock Income Securities Trust
JHX	James Hardie Industries Se
JHY	Nuveen High Income 2020 Target
JILL	J. Jill Inc
JKS	Jinkosolar Holding Company Ltd
JLL	Jones Lang Lasalle Inc
JLS	Nuveen Mortgage Opportunity Term Fund
JMEI	Jumei International Holding Ltd
JMF	Nuveen Energy MLP Total Return Fund
JMIA	Jumia Technologies Ag ADR
JMLP	Nuveen All Cap Energy MLP Oppo
JMM	Nuveen Multi-Market Income Fund Inc
JMP	JMP Group Inc
JMPB	JMP Group Inc
JMPD	JMP Group Llc 7.25% Senior Notes Due 2027
JMPE	JMP Group Llc 6.875% Senior Notes Due 2029
JMT	Nuven Mortgage Opportunity Term Fund 2
JNJ	Johnson & Johnson
JNPR	Juniper Networks
JOE	St. Joe Company
JOF	Japan Smaller Capitalization Fund Inc
JP	Jupai Holdings Ltd
JPC	Nuveen Preferred and Convertible
JPI	Nuveen Preferred and Income Term Fund
JPM	JP Morgan Chase & Company
JPM-A	Jpmorgan Chase & Co. [Jpm/Pa]
JPM-C	Jpmorgan Chase & Co. [Jpm/Pc]
JPM-D	Jpmorgan Chase & Co. [Jpm/Pd]
JPM-F	Jpmorgan Chase & Co. [Jpm/Pf]
JPM-G	Jpmorgan Chase & Co. [Jpm/Pg]
JPM-H	Jpmorgan Chase & Co. [Jpm/Ph]
JPS	Nuveen Quality Preferred 2
JPT	Nuveen Preferred and Income 2022 Term Fund
JQC	Nuveen Preferred and Convertible 2
JRI	Nuveen Real Asset Income and Gr
JRO	Nuveen Floating Rate Income Opportuntiy
JRS	Nuveen Real Estate Fund
JSD	Nuveen Short Duration Credit O
JT	Jianpu Technology Inc
JTA	Nuveen Tax-Advantaged Total Return
JTD	Nuveen Tax-Advantaged Dividend Growth
JW.A	John Wiley Sons Cl A
JW.B	John Wiley Sons Cl B
JWN	Nordstrom
K	Kellogg Company
KAI	Kadant Inc
KAMN	Kaman Corp
KAR	Kar Auction Services Inc
KB	KB Financial Group Inc
KBH	KB Home
KBR	KBR Inc
KDMN	Kadmon Holdings Llc
KDP	Keurig Dr Pepper Inc
KEG	Key Energy Services Inc
KEM	Kemet Corp
KEN	Kenon Holdings Ltd
KEP	Korea Electric Power Corp
KEX	Kirby Corp
KEY	Keycorp
KEY-I	Keycorp [Key/Pi]
KEY-J	Keycorp [Key/Pj]
KEY-K	Keycorp [Key/Pk]
KEYS	Keysight Technologies Inc Comm
KF	Korea Fund
KFS	Kingsway Financial Services
KFY	Korn/Ferry International
KGC	Kinross Gold Corp
KIM	Kimco Realty Corp
KIM-J	Kimco Rlty Corp [Kim/Pj]
KIM-L	Kimco Rlty Corp [Kim/Pl]
KIM-M	Kimco Realty Corp Dep Shs Repstg 1/1000 Shs Cl M
KIO	KKR Income Opportunities Fund
KKR	KKR & Co. LP
KKR-A	KKR & Co. Inc [Kkr/Pa]
KKR-B	KKR & Co. Inc [Kkr/Pb]
KL	Kirkland Lake Gold Ltd
KMB	Kimberly-Clark Corp
KMF	Kayne Anderson Midstream Energy Fund
KMI	Kinder Morgan
KMPR	Kemper Corp
KMT	Kennametal Inc
KMX	Carmax Inc
KN	Knowles Corp
KNL	Knoll Inc
KNOP	Knot Offshore Partners LP
KNX	Knight-Swift Transporation Inc
KO	Coca-Cola Company
KODK	Eastman Kodak
KOF	Coca Cola Femsa S.A.B. DE C.V.
KOP	Koppers Holdings Inc
KOS	Kosmos Energy Ltd
KR	Kroger Company
KRA	Kraton Performance Polymers Inc
KRC	Kilroy Realty Corp
KREF	KKR Real Estate Finance Trust Inc
KRG	Kite Realty Group Trust
KRO	Kronos Worldwide Inc
KRP	Kimbell Royalty Partners
KSM	Scudder Strategic Municiple Income Trust
KSS	Kohl's Corp
KSU	Kansas City Southern
KSU.P	Kansas City Southern [Ksu/P]
KT	Korea Telecom Corp
KTB	Kontoor Brands Inc [Ktb/I]
KTF	Scudder Municiple Income Trust
KTH	Lehman Abs Corp
KTN	Lehman Abs Corp
KTP	Lehman Abs Corp
KW	Kennedy-Wilson Holdings Inc
KWR	Quaker Chemical Corp
KYN	Kayne Anderson MLP Investment Company
KYN-F	Kayne Anderson MLP Midstream Invest [Kyn/Pf]
L	Loews Corp
LAC	Lithium Americas Corp
LAD	Lithia Motors
LADR	Ladder Capital Corp
LAIX	Laix Inc ADR
LAZ	Lazard Ltd
LB	L Brands Inc
LBRT	Liberty Oilfield Services Inc
LC	Lendingclub Corp
LCI	Lannett Co. Inc
LCII	Lci Industries
LDL	Lydall Inc
LDOS	Leidos Holdings Inc
LDP	Cohen & Steers Ltd Duration Prfd Income Fund
LEA	Lear Corp
LEAF	Leaf Group Ltd
LEE	Lee Enterprises Inc
LEG	Leggett & Platt Inc
LEJU	Leju Holdings Ltd
LEN	Lennar Corp
LEN.B	Lennar Corp Cl B
LEO	Dreyfus Strategic Municipals
LEVI	Levi Strauss & Co. Cl A
LFC	China Life Insurance Company Ltd
LGC	Legacy Acquisition Corp
LGC.U	Legacy Acquisition Corp [Lgc/U]
LGC.W	Legacy Acquisition Corp [Lgc/W]
LGF.A	Lions Gate Entertainment Corp Cl A
LGF.B	Lions Gate Entertainment Corp Cl B
LGI	Lazard Global Total Return and
LH	Laboratory Corp of America Holdings
LHC	Leo Holdings Corp Cl A
LHC.U	Leo Holdings Corp
LHC.W	Leo Holdings Corp [Lhc/W]
LHX	L3Harris Technologies Inc
LII	Lennox International
LIN	Linde Plc
LINX	Linx S.A. ADR
LITB	Lightinthebox Holding Co. Ltd
LKSD	Lsc Communications Inc
LL	Lumber Liquidators Holdings Inc
LLY	Eli Lilly and Company
LM	Legg Mason Inc
LMHA	Legg Mason Inc
LMHB	Legg Mason Inc
LMT	Lockheed Martin Corp
LN	Line Corp
LNC	Lincoln National Corp
LND	Brasilagro ADR
LNN	Lindsay Corp
LOMA	Loma Negra Comp Indu Argentina Sociedad ADR
LOR	Lazard World Dividend &
LOW	Lowe's Companies
LPG	Dorian Lpg Ltd
LPI	Laredo Petroleum Holdings Inc
LPL	Lg Display Co. Ltd
LPT	Liberty Property Trust
LPX	Louisiana-Pacific Corp
LRN	K12 Inc
LSI	Life Storage
LTC	Ltc Properties
LTHM	Livent Corp
LTM	Latam Airlines Group S.A.
LUB	Luby's Inc
LUV	Southwest Airlines Company
LVS	Las Vegas Sands
LW	Lamb Weston Holdings Inc
LXFR	Luxfer Holdings Plc
LXP	Lexington Realty Trust
LXP-C	Lexington Realty Trust [Lxp/Pc]
LXU	Lsb Industries Inc
LYB	Lyondellbasell Industries NV
LYG	Lloyds Banking Group Plc
LYV	Live Nation Entertainment
LZB	La-Z-Boy Inc
M	Macy's Inc
MA	Mastercard Inc
MAA	Mid-America Apartment Communities
MAA-I	Mid Amer Apt Cmntys Inc [Maa/Pi]
MAC	Macerich Company
MAIN	Main Street Capital Corp
MAN	Manpower Inc
MANU	Manchester United Ltd
MAS	Masco Corp
MATX	Matson Inc
MAV	Pioneer Muni High Income Advantage Trust
MAXR	Maxar Technologies Ltd
MBI	MBIA Inc
MBT	Mobile Telesystems
MC	Moelis
MCA	Blackrock Muniyield California Insured Fund
MCB	Metropolitan Bank Holding Corp
MCC	Medley Capital Corp
MCD	McDonald's Corp
MCI	Massmutual Corporate Investors
MCK	Mckesson Corp
MCN	Madison/Claymore Covered Call & Equity Strategy
MCO	Moody's Corp
MCR	MFS Charter Income Trust
MCRN	Milacron Holdings Corp
MCS	Marcus Corp
MCV	Medley Capital Corp
MCX	Medley Capital Corp
MCY	Mercury General Corp
MD	Mednax Inc
MDC	M.D.C. Holdings
MDLA	Medallia Inc
MDLQ	Medley Llc 7.25% Notes Due 2024
MDLX	Medley Llc
MDLY	Medley Management Inc
MDP	Meredith Corp
MDR	McDermott International
MDT	Medtronic Inc
MDU	Mdu Res Group Inc
MEC	Mayville Engineering Company Inc
MED	Medifast Inc
MEI	Methode Electronics
MEN	Blackrock Munienhanced Fund
MER-K	Bank of America Corp [Mer/Pk]
MET	Metlife Inc
MET-A	Metlife Inc [Met/Pa]
MET-E	Metlife Inc [Met/Pe]
MFA	MFA Financial Inc
MFA-B	MFA Finl Inc [Mfa/Pb]
MFA.U	Megalith Finl Acquisition Corp [Mfac.U]
MFA.W	Megalith Finl Acquisition Corp [Mfac/W]
MFAC	Megalith Financial Acquisition Corp Cl A
MFC	Manulife Financial Corp
MFD	Macquarie/First Trust Global
MFG	Mizuho Financial Group
MFGP	Micro Focus Intl Plc
MFL	Blackrock Muniholdings Investment Quality Fund
MFM	MFS Muni Income Trust
MFO	MFA Financial Inc
MFT	Blackrock Muniyield Investment Qualityfund
MFV	MFS Special Value Trust
MG	Mistras Group Inc
MGA	Magna International
MGF	MFS Government Markets Income Trust
MGM	MGM Resorts International
MGP	MGM Growth Properties Llc
MGR	Affiliated Managers Group Inc
MGU	Macquarie Global Infrastructure Total Return Fun
MGY	Magnolia Oil & Gas Corp
MH-A	Maiden Holdings Ltd [Mh/Pa]
MH-C	Maiden Holdings Ltd [Mh/Pc]
MH-D	Maiden Holdings Ltd [Mh/Pd]
MHD	Blackrock Muniholdings Fund
MHE	Massachusetts Health and Education Tax-Exempt TR
MHF	Western Asset Muni High
MHI	Pioneer Muni High Income Trust
MHK	Mohawk Industries
MHLA	Maiden Holdings Ltd 6.625% No
MHN	Blackrock Muniholdings New York Quality Fund
MHNC	Maiden Holdings North America
MHO	M/I Homes
MIC	Macquarie Infrastructure Company Trust
MIE	Cohen & Steers MLP Income and
MIN	MFS Intermediate Income Trust
MIT-A	Ag Mtg Invt TR Inc [Mitt/Pa]
MIT-B	Ag Mtg Invt TR Inc [Mitt/Pb]
MIT-C	Ag Mtg Invt TR Inc [Mitt/Pc]
MITT	Ag Mortgage Investment Trust
MIXT	Mix Telematics Ltd
MIY	Blackrock Muniyield Michigan Quality Fund
MKC	Mccormick & Company Inc
MKC.V	Mccormick & Co. Inc
MKL	Markel Corp
MLI	Mueller Industries
MLM	Martin Marietta Materials
MLP	Maui Land & Pineapple Company
MLR	Miller Industries
MMC	Marsh & Mclennan Companies
MMD	Mainstay Defined Muni Opp Fund
MMI	Marcus & Millichap
MMM	3M Company
MMP	Magellan Midstream Partners LP
MMS	Maximus Inc
MMT	MFS Multimarket Income Trust
MMU	Western Asset Managed Municipals Fund
MN	Manning & Napier Inc
MNE	Blackrock Muni New York Intermediate Duration Fu
MNK	Mallinckrodt Plc
MNP	Western Asset Muni Partners Fund
MNR	Monmouth Real Estate Investment Corp
MNR-C	Monmouth Real Estate Invt Corp [Mnr/Pc]
MNRL	Brigham Minerals Inc
MO	Altria Group
MOD	Modine Manufacturing Company
MODN	Model N Inc
MOG.A	Moog Inc Cl A
MOG.B	Moog Inc Cl B
MOGU	Mogu Inc ADR
MOH	Molina Healthcare Inc
MOS	Mosaic Company
MOS.U	Mosaic Acquisition Corp [Mosc.U]
MOS.W	Mosaic Acquisition Corp [Mosc/W]
MOSC	Mosaic Acquisition Corp
MOV	Movado Group Inc
MPA	Blackrock Muniyield Pennsylvania Quality Fund
MPC	Marathon Petroleum Corp
MPLX	Mplx LP
MPV	Massmutual Participation Investors
MPW	Medical Properties Trust
MPX	Marine Products Corp
MQT	Blackrock Muniyield Quality Fund II
MQY	Blackrock Muniyield Quality Fund
MR	Montage Resources Corp
MRC	Mrc Global Inc
MRK	Merck & Company
MRO	Marathon Oil Corp
MS	Morgan Stanley
MS-A	Morgan Stanley [Ms/Pa]
MS-E	Morgan Stanley [Ms/Pe]
MS-F	Morgan Stanley [Ms/Pf]
MS-G	Morgan Stanley [Ms/Pg]
MS-I	Morgan Stanley [Ms/Pi]
MS-K	Morgan Stanley [Ms/Pk]
MSA	Msa Safety Inc
MSB	Mesabi Trust
MSC	Studio City Intl Holdings Ltd ADR
MSCI	MSCI Inc
MSD	Morgan Stanley Emerging Markets Debt
MSG	The Madison Square Garden Comp
MSGN	Msg Networks Inc
MSI	Motorola Solutions
MSL	Midsouth Bancorp
MSM	Msc Industrial Direct Company
MT	Arcelormittal
MTB	M&T Bank Corp
MTD	Mettler-Toledo International
MTDR	Matador Resources Company
MTG	Mgic Investment Corp
MTH	Meritage Corp
MTL	Mechel Oao
MTL.P	Mechel Pao [Mtl/P]
MTN	Vail Resorts
MTOR	Meritor Inc
MTR	Mesa Royalty Trust
MTRN	Materion Corp
MTT	Western Asset Muni Defined Opportunity Trust Inc
MTW	Manitowoc Company
MTX	Minerals Technologies Inc
MTZ	Mastec Inc
MUA	Blackrock Muniassets Fund
MUC	Blackrock Muniholdings California Quality Fund
MUE	Blackrock Muniholdings Quality Fund II
MUFG	Mitsubishi Ufj Financial Group Inc
MUH	Blackrock Muniholdings Fund II
MUI	Blackrock Muni Intermediate Duration Fund Inc
MUJ	Blackrock Muniholdings New Jersey Insured Fund
MUR	Murphy Oil Corp
MUS	Blackrock Muniholdings Quality Fund
MUSA	Murphy USA Inc
MUX	Mcewen Mining Inc
MVC	MVC Capital
MVCD	MVC Capital Inc 6.25% Senior Notes Due 2022
MVF	Munivest Fund
MVO	Mv Oil Trust
MVT	Blackrock Munivest Fund II
MWA	Mueller Water Products
MX	Magnachip Semiconductor Corp
MXE	Mexico Equity and
MXF	Mexico Fund
MXL	Maxlinear Inc
MYC	Blackrock Muniyield California Fund
MYD	Blackrock Muniyield Fund
MYE	Myers Industries
MYF	Blackrock Muniyield Investment Fund
MYI	Blackrock Muniyield Quality Fund III
MYJ	Blackrock Muniyield New Jersey Fund
MYN	Blackrock Muniyield New York Quality Fund
MYOV	Myovant Sciences Ltd
MZA	Muniyield Arizona Fund
NAC	Nuveen California Divadv Fund
NAD	Nuveen Divadv Fund
NAN	Nuveen New York Divadv Fund
NAT	Nordic American Tanker Shipping Ltd
NAV	Navistar International Corp
NAV-D	Navistar International Corp [Nav/Pd]
NAZ	Nuveen Arizona Premium Fund
NBB	Nuveen Build America Bond Fund
NBHC	National Bank Holdings Corp
NBL	Noble Energy Inc
NBLX	Noble Midstream Partners LP
NBR	Nabors Industries
NBR-A	Nabors Industries Inc [Nbr/Pa]
NC	Nacco Industries
NCA	Nuveen California Muni Value Fund
NCB	Nuveen California Muni Value Fund 2
NCI	Navigant Consulting
NCLH	Norwegian Cruise Ord
NCR	NCR Corp
NCV	Agic Convertible &
NCV-A	Allianzgi Conv Income Fd [Ncv/Pa]
NCZ	Agic Convertible & II
NCZ-A	Allianzgi Conv Income Fd II [Ncz/Pa]
NDP	Tortoise Energy Independence F
NE	Noble Corp
NEA	Nuveen Insured Tax-Free Advantage Fund
NEE	Nextera Energy
NEE-I	Nextera Energy Capital Hldgs Inc [Nee/Pi]
NEE-J	Nextera Energy Capital Hldgs Inc [Nee/Pj]
NEE-K	Nextera Energy Capital Hldgs Inc [Nee/Pk]
NEE-N	Nextera Energy Capital Hldgs Inc [Nee/Pn]
NEE-O	Nextera Energy Inc. 4.872% Corporate Units
NEM	Newmont Mining Corp
NEP	Nextera Energy Partners LP
NET	Cloudflare Inc Cl A
NEU	Newmarket Corp
NEV	Nuveen Enhanced Muni Value Fund
NEW	Puxin Ltd
NEWM	New Media Investment Group Inc
NEWR	New Relic Inc
NEXA	Nexa Resources S.A.
NFC	New Frontier Corp
NFC.U	New Frontier Corp
NFC.W	New Frontier Corp [Nfc/W]
NFG	National Fuel Gas Company
NFJ	Nfj Dividend Interest & Premium Strategy Fund
NGG	National Grid Transco Plc
NGL	Ngl Energy Partners LP
NGL-A	Targa Resources Partners LP [Ngls/Pa]
NGL-B	Ngl Energy Partners LP [Ngl/Pb]
NGL-C	Ngl Energy Partners LP Perp Pfd Unit Cl C Fixed
NGS	Natural Gas Services Group
NGVC	Natural Grocers By Vitamin Cottage Inc
NGVT	Ingevity Corp
NHA	Nuveen Municipal
NHF	Nexpoint Credit Strategies Fund
NHI	National Health Investors
NI	NiSource Inc
NI-B	NiSource Inc [Ni/Pb]
NID	Nuveen Intermediate Duration M
NIE	Agic Equity & Convertible
NIM	Nuveen Maturities Fund
NINE	Nine Energy Service Inc
NIO	Nio Inc
NIQ	Nuveen Intermediate Duration Q
NJR	Newjersey Resources Corp
NJV	Nuveen New Jersey Muni Value Fund
NKE	Nike Inc
NKG	Nuveen Georgia Divadv Fund 2
NKX	Nuveen Insured California Tax-Free
NL	NL Industries
NLS	Nautilus Group
NLSN	Nielsen Holdings Plc
NLY	Annaly Capital Management Inc
NLY-D	Annaly Cap Mgmt Inc [Nly/Pd]
NLY-F	Annaly Cap Mgmt Inc [Nly/Pf]
NLY-G	Annaly Cap Mgmt Inc [Nly/Pg]
NLY-I	Annaly Cap Mgmt Inc [Nly/Pi]
NM	Navios Maritime Holdings Inc
NM-G	Navios Maritime Hldgs Inc [Nm/Pg]
NM-H	Navios Maritime Hldgs Inc [Nm/Ph]
NMCO	Nuveen Municipal Credit Opportunities Fund
NMFC	New Mountain Finance Corp
NMFX	New Mountain Finance Corp
NMI	Nuveen Muni
NMK-B	Niagara Mohawk Power Corp [Nmk/Pb]
NMK-C	Niagara Mohawk Power Corp [Nmk/Pc]
NMM	Navios Maritime Partners LP
NMR	Nomura Holdings Inc ADR
NMS	Nuveen Minnesota Municipal Inco
NMT	Nuveen Massachusetts Premium Fund
NMY	Nuveen Maryland Premium Fund
NMZ	Nuveen Muni High Income Opportunity
NNA	Navios Maritime Acquisition Corp
NNC	Nuveen North Carolina Premium Fund
NNI	Nelnet Inc
NNN	National Retail Properties
NNN-E	National Retail Pptys Inc [NNn/Pe]
NNN-F	National Retail Pptys Inc [NNn/Pf]
NNY	Nuveen New York Muni Value Fund
NOA	North American Energy Partners
NOAH	Noah Holdings Ltd
NOC	Northrop Grumman Corp
NOK	Nokia Corp
NOM	Nuveen Missouri Premium Fund
NOMD	Nomad Foods Ltd
NOV	National-Oilwell
NOVA	Sunnova Energy International Inc
NOW	Servicenow Inc
NP	Neenah Paper
NPK	National Presto Industries
NPN	Nuveen Pennsylvania Muni Value Fund
NPO	Enpro Industries
NPTN	Neophotonics Corp
NPV	Nuveen Virginia Premium Fund
NQP	Nuveen Pennsylvania Investment
NR	Newpark Resources
NRE	Northstar Realty Europe Corp C
NRG	NRG Energy
NRGX	Neurologix Inc
NRK	Nuveen Insured New York Tax-Free
NRP	Natural Resource Partners LP
NRT	North European Oil Royality Trust
NRUC	National Rural Utilities Coop Finance Corp 5.500
NRZ	New Residential Investment Corp
NRZ-A	New Residential Invt Corp [Nrz/Pa]
NRZ-B	New Residential Invt Corp [Nrz/Pb]
NS	Nustar Energy LP
NS-A	Nustar Energy LP [Ns/Pa]
NS-B	Nustar Energy LP [Ns/Pb]
NS-C	Nustar Energy LP [Ns/Pc]
NSA	National Storage Affiliates Tru
NSA-A	National Storage Affiliates TR [Nsa/Pa]
NSC	Norfolk Southern Corp
NSC.W	Nesco Hldgs Inc [Nsco/W]
NSCO	Nesco Holdings Inc
NSL	Nuveen Senior
NSP	Insperity Inc
NSS	Nustar Logistics LP
NTB	Bank of Butterfield Ltd
NTC	Nuveen Connecticut Premium Fund
NTEST.I	
NTEST.J	
NTEST.K	
NTG	Tortoise MLP Fund
NTP	Nam Tai Electronics
NTR	Nutrien Ltd
NTX	Nuveen Texas Quality
NTZ	Natuzzi S.P.A.
NUE	Nucor Corp
NUM	Nuveen Michigan Quality
NUO	Nuveen Ohio Quality
NUS	Nu Skin Enterprises
NUV	Nuveen Muni Value Fund
NUW	Nuveen Muni Value Fund
NVG	Nuveen Insured Divadv Fund
NVGS	Navigator Holdings
NVO	Novo Nordisk A/S
NVR	NVR Inc
NVRO	Nevro Corp
NVS	Novartis Ag
NVST	Envista Holdings Corp
NVT	Nvent Electric Plc
NVTA	Invitae Corp
NWE	Northwestern Corp
NWHM	New Home Co. Llc
NWN	Northwest Natural Gas Company
NX	Quanex Building Products Corp
NXC	Nuveen California Tax-Free Income
NXJ	Nuveen New Jersey Divadv Fund
NXN	Nuveen Insured New York Tax-Free
NXP	Nuveen Tax Free Income Portfolio
NXQ	Nuveen Tax Free Income Portfolio II
NXR	Nuveen Tax Free Income Portfolio III
NXRT	Nexpoint Residential Trust Inc
NYC-A	New York Community Bancorp Inc [Nycb/Pa]
NYC-U	New York Cmnty Cap TR V [Nycb/Pu]
NYCB	New York Community Bancorp
NYT	New York Times Company
NYV	Nuveen New York Muni Value Fund 2
NZF	Nuveen Divadv Fund 3
O	Realty Income Corp
OAC	Oaktree Acquisition Corp Cl A
OAC.U	Oaktree Acquisition Corp
OAC.W	Oaktree Acquisition Corp WT
OAK	Oaktree Capital Group Llc
OAK-A	Oaktree Cap Group Llc [Oak/Pa]
OAK-B	Oaktree Cap Group Llc [Oak/Pb]
OAS	Oasis Petroleum Inc
OBE	Obsidian Energy Ltd
OC	Owens Corning Inc
OCN	Ocwen Financial Corp
ODC	Oil-Dri Corp of America
OEC	Orion Engineered Carbons S.A R
OFC	Corporate Office Properties
OFG	Oriental Financial Group
OFG-A	Ofg Bancorp [Ofg/Pa]
OFG-B	Ofg Bancorp [Ofg/Pb]
OFG-D	Ofg Bancorp [Ofg/Pd]
OGE	Oge Energy Corp
OGS	One Gas Inc
OHI	Omega Healthcare Investors
OI	Owens-Illinois
OIA	Invesco Muni Income Trust
OIB.C	Oi S.A. [Oibr.C]
OII	Oceaneering International
OIS	Oil States International
OKE	Oneok Inc
OLN	Olin Corp
OLP	One Liberty Properties
OMC	Omnicom Group Inc
OMF	Onemain Holdings Inc
OMI	Owens & Minor
OMN	Omnova Solutions Inc
OMP	Oasis Midstream Partners LP
ONDK	On Deck Capital Inc
ONE	Onesmart International Education Group Ltd A
OOMA	Ooma Inc
OPP	Rivernorth/Doubleline Strategic Opportunity Fund
OPY	Oppenheimer Holdings
OR	Osisko Gold Royalties Ltd
ORA	Ormat Technologies
ORAN	Orange ADR
ORC	Orchid Island Capital Inc
ORCC	Owl Rock Capital Corp
ORCL	Oracle Corp
ORI	Old Republic International Corp
ORN	Orion Group Holdings Inc
OSB	Norbord Inc
OSG	Overseas Shipholding Group Inc
OSK	Oshkosh Truck Corp
OSLE	Oaktree Specialty Lending Corp
OUT	Outfront Media Inc
OXM	Oxford Industries
OXY	Occidental Petroleum Corp
PAA	Plains All American Pipeline LP
PAC	Grupo Aeroportuario Del Pacifico
PAC.W	Ranpak Hldgs Corp [Pack/W]
PACD	Pacific Drilling S.A.
PACK	Ranpak Holdings Corp
PAG	Penske Automotive Group
PAGP	Plains Gp Holdings LP
PAGS	Pagseguro Digital Ltd Cl A
PAI	Pacific American Income Shares
PAM	Pampa Energia S.A.
PANW	Palo Alto Networks Inc
PAR	Par Technology Corp
PARR	Par Petroleum Corp
PAYC	Paycom Software Inc
PB	Prosperity Bancshares
PBA	Pembina Pipeline Cor
PBB	Prospect Capital Corp
PBC	Prospect Capital Corp 6.875% Notes Due 20
PBF	PBF Energy Inc
PBFX	PBF Logistics LP
PBH	Prestige Brand Holdings
PBI	Pitney Bowes Inc
PBI-B	Pitney Bowes Inc [Pbi/Pb]
PBR	Petroleo Brasileiro S.A. Petrobras
PBR.A	Petroleo Brasileiro Sa Petrobr ADR
PBT	Permian Basin Royalty Trust
PBY	Prospect Capital Corp 6.25% Notes Due 202
PCF	Putnam High Income Bond Fund
PCG	Pacific Gas & Electric Company
PCI	Pimco Dynamic Credit Income Fun
PCK	Pimco California Muni II
PCM	Pimco Commercial Mortgage Securities
PCN	Pimco Corporate
PCQ	Pimco California Muni
PD	Pagerduty Inc
PDI	Pimco Dynamic Income Fund
PDM	Piedmont Office Realty Trust
PDS	Precision Drilling Corp
PDT	John Hancock Premium Dividend Fund
PE	Parsley Energy
PEB	Pebblebrook Hotel Trust
PEB-C	Pebblebrook Hotel TR [Peb/Pc]
PEB-D	Pebblebrook Hotel TR [Peb/Pd]
PEB-E	Pebblebrook Hotel TR [Peb/Pe]
PEB-F	Pebblebrook Hotel TR [Peb/Pf]
PEG	Public Service Enterprise Group Inc
PEI	Pennsylvania Real Estate Investment
PEI-B	Pennsylvania Rl Estate Invt TR [Pei/Pb]
PEI-C	Pennsylvania Rl Estate Invt TR [Pei/Pc]
PEI-D	Pennsylvania Rl Estate Invt TR [Pei/Pd]
PEN	Penumbra Inc
PEO	Adams Natural Resources Fund Inc
PER	Sandridge Permian Trust
PFD	Flaherty & Crumrine Preferred Inc
PFE	Pfizer Inc
PFGC	Performance Food Group Company
PFH	Cabco TR Jcp 7.625
PFL	Pimco Income Strategy Fund
PFN	Pimco Income Strategy Fund II
PFO	Flaherty & Crumrine Preferred Fund
PFS	Provident Financial Services
PFSI	Pennymac Financial Services IN
PG	Procter & Gamble Company
PGP	Pimco Global Stocksplus & Income
PGR	Progressive Corp
PGRE	Paramount Group Inc
PGTI	Pgt Inc
PGZ	Principal Real Estate Income F
PH	Parker-Hannifin Corp
PHD	Pioneer Floating Rate Trust
PHG	Koninklijke Philips Electronics
PHI	Philippine Long Distance Telephone
PHK	Pimco High Income Fund
PHM	Pultegroup
PHR	Phreesia Inc
PHT	Pioneer High Income Trust
PHX	Panhandle Royalty Company
PIC	Pivotal Investment Corp II Cl A
PIC.U	Pivotal Invt Corp II
PIC.W	Pivotal Invt Corp II [Pic/W]
PII	Polaris Industries Inc
PIM	Putnam Master Intermediate Income
PING	Ping Identity Holding Corp
PINS	Pinterest Inc
PIR	Pier 1 Imports
PIY	Merrill Lynch Depositor
PJC	Piper Jaffray Companies
PJH	Prudential Financial Inc
PJT	Pjt Partners Inc Cl A
PK	Park Hotels & Resorts Inc
PKD	Parker Drilling Company
PKE	Park Electrochemical Corp
PKG	Packaging Corp of America
PKI	Perkinelmer
PKO	Pimco Income Opportunity Fund
PKX	Posco ADR
PLAN	Anaplan Inc
PLD	Prologis Inc
PLNT	Planet Fitness
PLOW	Douglas Dynamics
PLT	Plantronics
PM	Philip Morris International Inc
PMF	Pimco Muni
PML	Pimco Muni II
PMM	Putnam Managed Muni Income Trust
PMO	Putnam Muni Opportunities Trust
PMT	Pennymac Mortgage Investment Trust
PMT-A	Pennymac Mtg Invt TR [Pmt/Pa]
PMT-B	Pennymac Mtg Invt TR [Pmt/Pb]
PMX	Pimco Muni Income Fund III
PNC	PNC Bank
PNC-P	PNC Financial Services Group [Pnc/Pp]
PNC-Q	PNC Financial Services Group [Pnc/Pq]
PNF	Pimco New York Muni
PNI	Pimco New York Muni II
PNM	PNM Resources Inc
PNR	Pentair Ltd
PNW	Pinnacle West Capital Corp
POL	Polyone Corp
POR	Portland General Electric Company
POST	Post Holdings Inc
PPDF	Ppdai Group Inc
PPG	PPG Industries
PPL	PPL Corp
PPR	VOYA Prime Rate Trust
PPT	Putnam Premier Income Trust
PPX	PPL Capital Funding Inc
PQG	Pq Group Holdings Inc
PRA	Pro-Assurance Corp
PRE-F	Partnerre Ltd [Pre/Pf]
PRE-G	Partnerre Ltd [Pre/Pg]
PRE-H	Partnerre Ltd [Pre/Ph]
PRE-I	Partnerre Ltd [Pre/Pi]
PRGO	Perrigo Company
PRH	Prudential Financial Inc
PRI	Primerica Inc
PRI-A	Priority Income Fund Inc [Prif/Pa]
PRI-B	Priority Income Fund Inc [Prif/Pb]
PRI-C	Priority Income Fund Inc [Prif/Pc]
PRI-D	Priority Income Fund Inc [Prif/Pd]
PRI-E	Priority Income Fund Inc 6.375% Prf Redeem 31/12
PRLB	Proto Labs Inc
PRO	Pros Holdings
PROS	Prosight Global Inc
PRS	Prudential Financial Inc 5.625% Junior
PRSP	Perspecta Inc
PRT	Permrock Royalty Trust Trust Units
PRTY	Party City Holdco Inc
PRU	Prudential Financial Inc
PSA	Public Storage
PSA-A	Public Storage [Psa/Pa]
PSA-B	Public Storage [Psa/Pb]
PSA-C	Public Storage [Psa/Pc]
PSA-D	Public Storage [Psa/Pd]
PSA-E	Public Storage [Psa/Pe]
PSA-F	Public Storage [Psa/Pf]
PSA-G	Public Storage [Psa/Pg]
PSA-H	Public Storage [Psa/Ph]
PSA-I	Public Storage - 4.875% Prf Perpetual USD - Ser
PSA-U	Public Storage [Psa/Pu]
PSA-V	Public Storage [Psa/Pv]
PSA-W	Public Storage [Psa/Pw]
PSA-X	Public Storage [Psa/Px]
PSB	Business Parks
PSB-U	PS Business Pks Inc Calif [Psb/Pu]
PSB-V	PS Business Pks Inc Calif [Psb/Pv]
PSB-W	PS Business Pks Inc Calif [Psb/Pw]
PSB-X	PS Business Pks Inc Calif [Psb/Px]
PSB-Y	PS Business Pks Inc Calif [Psb/Py]
PSF	Cohen & Steers Preferred Fund
PSN	Parsons Corp
PSO	Pearson Plc
PSTG	Pure Storage Inc
PSTL	Postal Realty Trust Cl A
PSV	Hermitage Offshore Services Ltd.
PSX	Phillips 66
PSXP	Phillips 66 Partners LP
PTR	Petrochina Company Ltd
PTY	Pimco Corporate Opportunity Fund
PUK	Prudential Public Ltd Company
PUK-A	Prudential [Puk/Pa]
PUK.P	Prudential [Puk/P]
PUMP	Propetro Holding Corp
PVG	Pretium Res Inc
PVH	Phillips-Van Heusen Corp
PVL	Permianville Royalty Trust
PVT	Pivotal Acquisition Corp Cl A
PVT.U	Pivotal Acquisition Corp
PVT.W	Pivotal Acquisition Corp [Pvt/W]
PVTL	Pivotal Software Inc
PWR	Quanta Services
PXD	Pioneer Natural Resources Company
PYN	Pimco New York Muni Income Fund III
PYS	Pplus Trust
PYT	Pplus Trust
PYX	Pyxus International Inc
PZC	Pimco California Muni Income Fund III
PZN	Pzena Investment Management Inc
QD	Qudian Inc ADR
QEP	Qep Resources
QES	Quintana Energy Services Inc
QGEN	Qiagen N.V.
QHC	Quorum Health Corp
QSR	Restaurant Brands International
QTS	Qts Realty Trust Inc
QTS-A	Qts Rlty TR Inc [Qts/Pa]
QTS-B	Qts Rlty TR Inc [Qts/Pb]
QTWO	Q2 Holdings Inc
QUAD	Quad Graphics Inc
QUOT	Quotient Technology Inc
QVCD	Qvc Inc 6.375% Senior Secured Notes Due 2067
R	Ryder System
RA	Brookfield Real Assets Income Fund Inc
RACE	Ferrari N.V.
RAD	Rite Aid Corp
RAMP	Liveramp Holdings Inc
RBA	Ritchie Bros. Auctioneers Inc
RBC	Regal-Beloit Corp
RBS	Royal Bank Scotland Group Plc
RC	Ready Capital Corp
RCA	Ready Capital Corp 7.00%
RCB	Ready Capital Corp 6.20% Senior Notes Due
RCI	Rogers Communication
RCL	Royal Caribbean Cruises Ltd
RCP	Ready Capital Corp 6.50% Series
RCS	Rcm Strategic Global Government Fund
RCUS	Arcus Biosciences Inc
RDN	Radian Group Inc
RDS.A	Royal Dutch Shell ADR Cl A
RDS.B	Royal Dutch Shell Cl B
RDY	Dr. Reddy's Laboratories Ltd
RE	Everest Re Group
RELX	Relx Plc
RENN	Renren Inc
RES	RPC Inc
RESI	Altisource Residential Corp
REV	Revlon Inc
REVG	Rev Group Inc
REX	Rex American Resources Corp
REX-A	Rexford Indl Rlty Inc [Rexr/Pa]
REX-B	Rexford Indl Rlty Inc [Rexr/Pb]
REX-C	Rexford Industrial Realty Inc 5.625% Prf Perpetu
REXR	Rexford Industrial Realty Inc
REZI	Resideo Technologies Inc
RF	Regions Financial Corp
RF-A	Regions Financial Corp [Rf/Pa]
RF-B	Regions Financial Corp [Rf/Pb]
RF-C	Regions Financial Corp [Rf/Pc]
RFI	Cohen & Steers Total Return Realty Fund
RFP	Resolute Forest Products Inc
RGA	Reinsurance Group of America Inc
RGR	Sturm Ruger & Company
RGS	Regis Corp
RGT	Royce Global Value Trust Inc
RH	Restoration Hardware Holdings
RHI	Robert Half International Inc
RHP	Ryman Hospitality Properties REIT
RIG	Transocean Inc
RIO	Rio Tinto Plc
RIV	Rivernorth Opportunities Fund
RIV-R	Rivernorth Opprtunities Fd I [Riv/R]
RJF	Raymond James Financial
RL	Ralph Lauren Corp
RLGY	Realogy Holdings Corp
RLH	Red Lion Hotels Corp
RLI	Rli Corp
RLJ	Rlj Lodging Trust
RLJ-A	Rlj Lodging TR [Rlj/Pa]
RM	Regional Managment Corp
RMAX	Re/Max Holdings Inc
RMD	Resmed Inc
RMED	Ra Medical Systems Inc
RMG	Rmg Acquisition Corp Cl A
RMG.U	Rmg Acquisition Corp
RMG.W	Rmg Acquisition Corp [Rmg/W]
RMI	Rivernorth Opportunistic Municipal Income Fund
RMM	Rivernorth Managed Duration Municipal Income Fun
RMP.P	Rivernorth Marketplace Lending Corp [Rmpl/P]
RMT	Royce Micro-Cap Trust
RNG	Ringcentral Inc
RNGR	Ranger Energy Services Inc Cl A
RNP	Cohen & Steers REIT and Preferred
RNR	Renaissancere Holdings Ltd
RNR-C	Renaissancere Holdings Ltd [Rnr/Pc]
RNR-E	Renaissancere Holdings Ltd [Rnr/Pe]
RNR-F	Renaissancere Holdings Ltd [Rnr/Pf]
ROAN	Roan Resources Inc
ROG	Rogers Corp
ROK	Rockwell Automation Inc
ROL	Rollins Inc
ROP	Roper Industries
ROYT	Pacific Coast Oil Trust
RPAI	Retail Properties of America
RPL.U	Replay Acquisition Corp [Rpla.U]
RPL.W	Replay Acquisition Corp [Rpla/W]
RPLA	Replay Acquisition Corp
RPM	RPM International Inc
RPT	Ramco-Gershenson Properties Trust
RPT-D	Rpt Realty [Rpt/Pd]
RQI	Cohen & Steers Quality Income Realty Fund Inc
RRC	Range Resources Corp
RRD	Donnelley [R.R.] & Sons Company
RRTS	Roadrunner Transportation Systems Inc
RS	Reliance Steel & Aluminum Company
RSF	Rivernorth Marketplace Lending Corp
RSG	Republic Services
RST	Rosetta Stone
RTEC	Rudolph Technologies
RTN	Raytheon Company
RTW	Rtw Retailwinds Inc
RUBI	The Rubicon Project Inc
RVI	Retail Value Inc
RVLV	Revolve Group Inc
RVT	Royce Value Trust
RWG.U	Regalwood Global Energy Ltd [Rwge.U]
RWG.W	Regalwood Global Energy Ltd [Rwge/W]
RWGE	Regalwood Global Energy Ltd Cl A
RWT	Redwood Trust
RXN	Rexnord Corp
RXN-A	Rexnord Corp [New] [Rxn/Pa]
RY	Royal Bank of Canada
RY-T	Royal Bank of Canada [Ry/Pt]
RYAM	Rayonier Advanced Materials Inc
RYB	Ryb Education Inc Aps
RYI	Ryerson Holding Corp
RYN	Rayonier Inc REIT
RZA	Reinsurance Group of America
RZB	Reinsurance Group of America
S	Sprint Corp
SA	Seabridge Gold
SAB	Saratoga Investment Corp 6.75% Notes Due 2023
SAF	Saratoga Investment Corp
SAFE	Safehold Inc
SAH	Sonic Automotive
SAIC	Science Applications International
SAIL	Sailpoint Technologies Holdings Inc
SALT	Scorpio Bulkers Inc
SAM	Boston Beer Company
SAN	Banco Santander
SAN-B	Banco Santander Sa [San/Pb]
SAP	SAP Ag
SAR	Saratoga Investment Corp
SAVE	Spirit Airlines Inc
SB	Safe Bulkers Inc
SB-C	Safe Bulkers Inc [Sb/Pc]
SB-D	Safe Bulkers Inc [Sb/Pd]
SBE	Switchback Energy Acquisition Corp Cl A
SBE.U	Switchback Energy Acquisition Corp
SBE.W	Switchback Energy Acquisition Corp WT
SBGL	Sibanye Gold Ltd ADR
SBH	Sally Beauty Holdings
SBI	Western Asset Intermediate Fund Inc
SBNA	Scorpio Tankers Inc
SBOW	Silverbow Resources Inc
SBR	Sabine Royalty Trust
SBS	Cia DE Saneamento Basico Do Estado
SC	Santander Consumer USA Holdings
SCA	Stellus Capital Investment 5.75% Notes Due 2022
SCCO	Southern Peru Copper Corp
SCD	Lmp Capital and Income Fund Inc
SCE-G	Sce Trust II [Sce/Pg]
SCE-H	Sce TR III [Sce/Ph]
SCE-J	Sce TR IV [Sce/Pj]
SCE-K	Sce Trust V [Sce/Pk]
SCE-L	Sce Trust Vi [Sce/Pl]
SCH-C	Charles Schwab Corp [Schw/Pc]
SCH-D	Charles Schwab Corp [Schw/Pd]
SCHW	The Charles Schwab Corp
SCI	Service Corp International
SCL	Stepan Company
SCM	Stellus Capital Investment Cor
SCP.U	SC Health Corp [Scpe.U]
SCP.W	SC Health Corp [Scpe/W]
SCPE	SC Health Corp Cl A
SCS	Steelcase Inc
SCU	Sculptor Capital Management Inc.
SCX	L.S. Starrett Company
SD	Sandridge Energy Inc
SDR	Sandridge Mississippian Trust
SDRL	Seadrill Ltd
SDT	Sandridge Mississippian Trust
SE	Sea Ltd ADR
SEAS	Seaworld Entertainment Inc Company
SEE	Sealed Air Corp
SEM	Select Medical Holdings Corp
SEMG	Semgroup Corp
SERV	Servicemaster Global Holdings
SF	Stifel Financial Corp
SF-A	Stifel Financial Corp [Sf/Pa]
SF-B	Stifel Financial Corp [Sf/Pb]
SFB	Stifel Financial Corp 5.20% Senior Notes
SFE	Safeguard Scientifics
SFL	Ship Finance International
SFUN	Soufun Holdings
SGU	Star Gas Partners LP
SHAK	Shake Shack Inc
SHG	Shinhan Financial Group Co. Ltd
SHI	Sinopec Shangai Petrochemical Company Ltd
SHL.U	Tortoise Acquisition Corp [Shll.U]
SHL.W	Tortoise Acquisition Corp [Shll/W]
SHLL	Tortoise Acquisition Corp Cl A
SHLX	Shell Midstream Partners LP
SHO	Sunstone Hotel Investors
SHO-E	Sunstone Hotel Invs Inc [Sho/Pe]
SHO-F	Sunstone Hotel Invs Inc [Sho/Pf]
SHOP	Shopify Inc
SHW	Sherwin-Williams Company
SID	Companhia Siderurgica Nacional
SIG	Signet Jewelers Ltd
SIT-A	Site Centers Corp Shs Pfd Cl A
SIT-J	Site Centers Corp [Sitc/Pj]
SIT-K	Site Centers Corp [Sitc/Pk]
SITC	Site Centers Corp
SITE	Siteone Landscape Supply
SIX	Six Flags Entertainment Corp
SJI	South Jersey Industries
SJIJ	South Jersey Industries Inc 5.625% Junior Subor
SJIU	South Jersey Industries Inc
SJM	J.M. Smucker Company
SJR	Shaw Communications Inc
SJT	San Juan Basin Royalty Trust
SJW	SJW Corp
SKM	Sk Telecom Corp
SKT	Tanger Factory Outlet Centers
SKX	Skechers U.S.A.
SKY	Skyline Corp
SLB	Schlumberger N.V.
SLCA	U.S. Silica Holdings Inc
SLF	Sun Life Financial Inc
SLG	SL Green Realty Corp
SLG-I	SL Green Rlty Corp [Slg/Pi]
SM	Sm Energy Company
SMAR	Smartsheet Inc Cl A
SMFG	Sumitomo Mitsui Financial Group Inc
SMG	Scotts Miracle-Gro Company
SMHI	Seacor Marine Holdings Inc
SMLP	Summit Midstream Partners LP
SMM	Salient Midstream & MLP Fund
SMP	Standard Motor Products
SMTA	Spirit Mta REIT
SNA	Snap-On Inc
SNAP	Snap Inc
SNDR	Schneider National Inc
SNE	Sony Corp
SNN	Smith & Nephew Snats
SNP	China Petroleum & Chemical Corp
SNR	New Senior Investment Group Inc
SNV	Synovus Financial Corp
SNV-D	Synovus Financial Corp [Snv/Pd]
SNV-E	Synovus Finl Corp [Snv/Pe]
SNX	Synnex Corp
SO	Southern Company
SOGO	Sogou Inc
SOI	Solaris Oilfield Infrastructure Inc Cl A
SOJA	The Southern Co. Series
SOJB	Southern Company
SOJC	Southern Company Series 2017B 5.25% Junior Subor
SOL	Renesola Ltd
SOLN	Southern Company
SON	Sonoco Products Company
SOR	Source Capital
SPA.U	Spartan Energy Acquisiton Corp [Spaq.U]
SPA.W	Spartan Energy Acquisiton Corp [Spaq/W]
SPAQ	Spartan Energy Acquisition Corp Cl A
SPB	Spectrum Brands Holdings Inc
SPE	Special Opportunities Fund Inc
SPE-B	Special Opportunities Fd Inc [Spe/Pb]
SPG	Simon Property Group
SPG-J	Simon Ppty Group Inc [Spg/Pj]
SPGI	S&P Global Inc
SPH	Suburban Propane Partners LP
SPL-A	Steel Partners Holdings LP [Splp/Pa]
SPLP	Steel Partners Hldgs
SPN	Superior Energy Services
SPOT	Spotify Technology S.A.
SPR	Spirit Aerosystems Holdings
SPXC	SPX Corp
SPXX	Nuveen Equity Premium and Growth Fund
SQ	Square
SQM	Sociedad Quimica Y Minera S.A.
SQNS	Sequans Communications S A
SR	Spire Inc
SR-A	Spire Inc [Sr/Pa]
SRC	Spirit Realty Capital Inc
SRC-A	Spirit Rlty Cap Inc [Src/Pa]
SRE	Sempra Energy
SRE-A	Sempra Energy [Sre/Pa]
SRE-B	Sempra Energy [Sre/Pb]
SREA	Sempra Energy 5.750% Junior Subordinated Notes D
SRF	The Cushing Royalty & Income Fund
SRG	Seritage Growth Properties
SRG-A	Seritage Growth Pptys [Srg/Pa]
SRI	Stoneridge Inc
SRL	Scully Royalty Ltd.
SRLP	Sprague Resources LP
SRT	Startek Inc
SRV	The Cushing MLP Total Return Fund
SSD	Simpson Manufacturing Company
SSI	Stage Stores
SSL	Sasol Ltd
SSTK	Shutterstock Inc
SSW	Seaspan Corp
SSW-D	Seaspan Corp [Ssw/Pd]
SSW-E	Seaspan Corp [Ssw/Pe]
SSW-G	Seaspan Corp [Ssw/Pg]
SSW-H	Seaspan Corp [Ssw/Ph]
SSW-I	Seaspan Corp [Ssw/Pi]
SSWA	Seaspan Corp 7.125% Notes Due 2027
ST	Sensata Technologies Holding N.V.
STA-C	Stag Indl Inc [Stag/Pc]
STA-D	Istar Inc [Star/Pd]
STA-G	Istar Inc [Star/Pg]
STA-I	Istar Inc [Star/Pi]
STAG	STI Inc
STAR	Istar Financial Inc
STC	Stewart Information Services Corp
STE	Steris Corp
STG	Sunlands Online Education Group ADR
STI	Suntrust Banks
STI-A	Suntrust Banks Inc [Sti/Pa]
STK	Columbia Seligman Premium Technology
STL	Sterling Bancorp
STL-A	Sterling Bancorp D [Stl/Pa]
STM	Stmicroelectronics N.V.
STN	Stantec Inc
STNG	Scorpio Tankers Inc
STON	Stonemor Partners LP
STOR	Store Capital Corpstore Capital
STT	State Street Corp
STT-C	State Street Corp [Stt/Pc]
STT-D	State Street Corp [Stt/Pd]
STT-E	State Street Corp [Stt/Pe]
STT-G	State Street Corp [Stt/Pg]
STWD	Starwood Property Trust
STZ	Constellation Brands Inc
STZ.B	Constellation Brd Cl B
SU	Suncor Energy Inc
SUI	Sun Communities
SUM	Summit Materials Inc
SUN	Sunoco LP
SUP	Superior Industries International
SUPV	Grupo Supervielle S.A.
SUZ	Suzano Papel E Celul
SWCH	Switch Inc
SWI	Solarwinds Corp
SWJ	Stanley Black & Decker Inc
SWK	Stanley Black & Decker Inc
SWM	Schweitzer-Mauduit International
SWN	Southwestern Energy Company
SWP	Stanley Black & Decker Inc
SWX	Southwest Gas Corp
SWZ	Swiss Helvetia Fund
SXC	Suncoke Energy Inc
SXI	Standex International Corp
SXT	Sensient Technologies Corp
SYF	Synchrony Financial
SYK	Stryker Corp
SYX	Systemax Inc
SYY	Sysco Corp
SZC	The Cushing Renaissance Fund
T	AT&T Inc
TAC	Transalta Corp
TAK	Takeda Pharmaceutical Co. Ltd
TAL	Tal Education Group
TALO	Talos Energy Inc
TAP	Molson Coors Brewing Company
TAP.A	Molson Coors Brewing Cl A
TARO	Taro Pharm Inds
TBB	AT&T Inc 5.350% Global Notes Due 2066
TBC	AT&T Inc 5.625% Global Notes Due 2067
TBI	Trueblue Inc
TCI	Transcontinental Realty Investors
TCO	Taubman Centers
TCO-J	Taubman Ctrs Inc [Tco/Pj]
TCO-K	Taubman Ctrs Inc [Tco/Pk]
TCP	TCP Pipelines
TCRW	THL Credit Inc 6.125% Notes Due 2023
TCRZ	THL Credit Inc
TCS	The Container Store Group Inc
TD	Toronto Dominion Bank
TDA	Telephone and Data Systems Inc
TDC	Teradata Corp
TDE	Telephone and Data Systems
TDF	Templeton Dragon Fund
TDG	Transdigm Group Inc
TDI	Telephone and Data Systems
TDJ	Telephone and Data Systems Inc
TDOC	Teladoc Health Inc
TDS	Telephone and Data Systems
TDW	Tidewater Inc
TDW.A	Tidewater Inc [Tdw/Wa]
TDW.B	Tidewater Inc [Tdw/Wb]
TDY	Teledyne Technologies Inc
TEAF	Tortoise Essential Assets Income Term Fund
TECK	Teck Resources Ltd
TEF	Telefonica S.A.
TEI	Templeton Emerging Markets
TEL	Te Connectivity Ltd
TEN	Tenneco Automotive
TEO	Telecom Argentina Stet - France Telecom S.A.
TEVA	Teva Pharmaceutical Industries Ltd
TEX	Terex Corp
TFX	Teleflex Inc
TG	Tredegar Corp
TGE	Tallgrass Energy Gp LP
TGH	Textainer Group Holdings
TGI	Triumph Group
TGNA	Tegna Inc
TGP	Teekay Lng Partners LP
TGP-A	Teekay Lng Partners LP [Tgp/Pa]
TGP-B	Teekay Lng Partners LP [Tgp/Pb]
TGS	Transportadora DE Gas Sa Ord B
TGT	Target Corp
THC	Tenet Healthcare Corp
THG	The Hanover Insurance Group
THGA	The Hanover Insurance Group
THO	Thor Industries
THQ	Tekla Healthcare Opportunities
THR	Thermon Group Holdings Inc
THS	Treehouse Foods
THW	Tekla World Healthcare Fund
TIF	Tiffany & Company
TISI	Team Inc
TJX	TJX Companies
TK	Teekay Shipping Corp
TKC	Turkcell Iletisim Hizmetleri As
TKR	Timken Company
TLI	Lmp Corporate Loan Fund Inc
TLK	P.T. Telekomunikasi Indonesia Tbk
TLRA	Telaria Inc
TLRD	Tailored Brands Inc
TLYS	Tilly's Inc
TM	Toyota Motor Corp Ltd Ord
TME	Tencent Music Entertainment Group ADR
TMHC	Taylor Morrison Home Corp
TMO	Thermo Fisher Scientific Inc
TMST	Timken Steel Corp
TNC	Tennant Company
TNET	Trinet Group Inc
TNK	Teekay Tankers Ltd
TNP	Tsakos Energy Navigation Ltd
TNP-C	Tsakos Energy Navigation [Tnp/Pc]
TNP-D	Tsakos Energy Navigation [Tnp/Pd]
TNP-E	Tsakos Energy Navigation [Tnp/Pe]
TNP-F	Tsakos Energy Navigation [Tnp/Pf]
TOL	Toll Brothers Inc
TOO	Teekay Offshore Partners LP
TOO-A	Teekay Offshore Partners LP [Too/Pa]
TOO-B	Teekay Offshore Partners LP [Too/Pb]
TOO-E	Teekay Offshore Partners LP [Too/Pe]
TOT	Totalfinaelf S.A.
TOWR	Tower International
TPB	Turning Point Brands
TPC	Tutor Perini Corp
TPG.H	Tpg Pace Hldgs Corp [Tpgh.U]
TPG.I	Tpg Pace Hldgs Corp [Tpgh/W]
TPGH	Tpg Pace Holdings Corp Cl A
TPH	Tri Pointe Homes Inc
TPL	Texas Pacific Land Trust
TPR	Tapestry Inc
TPRE	Third Point Reinsurance Ltd Company
TPVG	Triplepoint Venture Growth Bdc
TPVY	Triplepoint Venture Growth Bdc Corp 5.75% Notes
TPX	Tempur-Pedic International Inc
TPZ	Tortoise Power and Energy
TR	Tootsie Roll Industries
TRC	Tejon Ranch Company
TREC	Trecora Resources
TREX	Trex Company
TRGP	Targa Resources
TRI	Thomson Reuters Corp
TRN	Trinity Industries
TRN.U	Trine Acquisition Corp [Trne.U]
TRN.W	Trine Acquisition Corp [Trne/W]
TRNE	Trine Acquisition Corp Cl A
TRNO	Terreno Realty Corp
TROX	Tronox Inc
TRP	Transcananda Pipelines
TRQ	Turquoise Hill Resources Ltd
TRT-A	Triton Intl Ltd [Trtn/Pa]
TRT-B	Triton Intl Ltd [Trtn/Pb]
TRTN	Triton International Ltd
TRTX	Tpg Re Finance Trust Inc
TRU	Transunion
TRV	The Travelers Companies Inc
TRWH	Twin River Worldwide Holdings Inc
TS	Tenaris S.A.
TSE	Trinseo S.A.
TSI	Tcw Strategic
TSLF	THL Credit Senior Loan Fund
TSLX	Tpg Specialty Lending Inc
TSM	Taiwan Semiconductor Manufacturing
TSN	Tyson Foods
TSQ	Townsquare Media Llc
TSU	Tim Participacoes S.A.
TTC	Toro Company
TTI	Tetra Technologies
TTM	Tata Motors Ltd
TTP	Tortoise Pipeline & Energy Fund
TU	Telus Corp Non Voting Shares
TUFN	Tufin Software Technologies Ltd.
TUP	Tupperware Corp
TV	Grupo Televisa S.A.
TVC	Tennessee Valley Authority
TVE	Tennessee Valley Authority
TWI	Titan International
TWLO	Twilio
TWN	Taiwan Fund
TWO	Two Harbors Investments Corp
TWO-A	Two Hbrs Invt Corp [Two/Pa]
TWO-B	Two Hbrs Invt Corp [Two/Pb]
TWO-C	Two Hbrs Invt Corp [Two/Pc]
TWO-D	Two Hbrs Invt Corp [Two/Pd]
TWO-E	Two Hbrs Invt Corp [Two/Pe]
TWTR	Twitter Inc
TX	Ternium S.A.
TXT	Textron Inc
TY	Tri Continental Corp
TY.P	Tri Contl Corp [Ty/P]
TYG	Tortoise Energy Infrastructure Corp
TYL	Tyler Technologies
UA	Under Armour Inc Cl C
UAA	Under Armour
UAN	Cvr Partners LP
UBA	Urstadt Biddle Properties Inc
UBER	Uber Technologies Inc
UBP	Urstadt Biddle Properties Inc
UBP-G	Urstadt Biddle Pptys Inc [Ubp/Pg]
UBP-H	Urstadt Biddle Pptys Inc [Ubp/Ph]
UBP-K	Urstadt Biddle Properties Inc 5.875% Prf Perpetu
UBS	UBS Group Ag
UDR	United Dominion Realty Trust
UE	Urban Edge Properties
UFI	Unifi Inc
UFS	Domtar Corp
UGI	Ugi Corp
UGP	Ultrapar Participacoes S.A.
UHS	Universal Health Services
UHT	Universal Health Realty Income Trust
UI	Ubiquiti Networks
UIS	Unisys Corp
UL	Unilever Plc
UMC	United Microelectronics Corp
UMH	Umh Properties
UMH-B	Umh Pptys Inc [Umh/Pb]
UMH-C	Umh Pptys Inc [Umh/Pc]
UMH-D	Umh Pptys Inc [Umh/Pd]
UN	Unilever NV
UNF	Unifirst Corp
UNFI	United Nat Foods
UNH	Unitedhealth Group Inc
UNM	Unumprovident Corp
UNMA	Unum Group 6.250% Junior Subordinated Notes Due
UNP	Union Pacific Corp
UNT	Unit Corp
UNVR	Univar Inc
UPS	United Parcel Service
URI	United Rentals
USA	Liberty All-Star Equity Fund
USAC	USA Compression Partners LP
USB	U.S. Bancorp
USB-A	US Bancorp [Usb/Pa]
USB-H	US Bancorp [Usb/Ph]
USB-M	US Bancorp [Usb/Pm]
USB-O	US Bancorp [Usb/Po]
USB-P	US Bancorp Del [Usb/Pp]
USDP	USD Partners LP
USFD	US Foods Holding
USM	United States Cellular Corp
USNA	Usana Health Sciences Inc
USPH	U.S. Physical Therapy
USX	U.S. Xpress Enterprises Inc Cl A
UTF	Cohen & Steers Infrastructure Fund
UTI	Universal Technical Institute Inc
UTL	Unitil Corp
UTX	United Technologies Corp
UVE	Universal Insurance Holdings Inc
UVV	Universal Corp
UZA	United States Cellular Corp
UZB	United States Cellular Corp
UZC	United States Cellular Corp
V	Visa Inc
VAC	Marriot Vacations Worldwide Cor
VAL	Valaris Plc
VALE	Vale S.A.
VAM	The Vivaldi Opportunities Fund
VAPO	Vapotherm Inc
VAR	Varian Medical Systems
VBF	Invesco Van Kampen Bond Fund
VCIF	Vertical Capital Income Fund Common Shares of BE
VCRA	Vocera Communications Inc
VCV	Invesco California Value Muni Income Trust
VEC	Vectrus Inc
VEDL	Vedanta Ltd
VEEV	Veeva Systems Inc
VER	Vereit Inc
VER-F	Vereit Inc [Ver/Pf]
VET	Vermilion Energy Inc
VFC	V.F. Corp
VG	Vonage Holdings
VGI	Virtus Global Multi-Sector Inc
VGM	Invesco Trust For Investment Grade Municipals
VGR	Vector Group Ltd
VHI	Valhi Inc
VICI	Vici Properties Inc
VIPS	Vipshop Holdings Ltd
VIST	Vista Oil & Gas S.A.B. DE C.V.
VIV	Telecomunicacoes DE Sao Paulo ADR
VJET	Voxeljet Ag
VKQ	Invesco Muni Trust
VLO	Valero Energy Corp
VLRS	Controladora Vuela Compaia DE
VLT	Invesco High
VMC	Vulcan Materials Company
VMI	Valmont Industries
VMO	Invesco Muni Opportunity Trust
VMW	Vmware Inc
VNCE	Vince Holding Corp
VNE	Veoneer Inc
VNO	Vornado Realty Trust
VNO-K	Vornado Rlty TR [Vno/Pk]
VNO-L	Vornado Rlty TR [Vno/Pl]
VNO-M	Vornado Rlty TR [Vno/Pm]
VNTR	Venator Materials Plc
VOC	Voc Energy Trust
VOY-B	VOYA Finl Inc [Voya/Pb]
VOYA	VOYA Financial Inc
VPG	Vishay Precision Group
VPV	Invesco Pennsylvania Muni
VRS	Verso Corp
VRTV	Veritiv Corp
VSH	Vishay Intertechnology
VSI	Vitamin Shoppe Inc
VSLR	Vivint Solar Inc
VSM	Versum Materials Inc
VST	Vistra Energy Corp
VST.A	Vistra Energy Corp [Vst/Wa]
VSTO	Vista Outdoor Inc
VTA	Invesco Dynamic Credit Fund
VTN	Invesco Trust New York Muni
VTR	Ventas Inc
VVI	Viad Corp
VVR	Invesco Senior Income Trust
VVV	Valvoline Inc
VZ	Verizon Communications Inc
W	Wayfair Inc
WAAS	Aquaventure Holdings Ltd
WAB	Wabtec Corp
WAIR	Wesco Aircraft Holdings Inc
WAL	Western Alliance Bancorp
WALA	Western Alliance Bancorp
WAT	Waters Corp
WBAI	500Wan.com Ltd
WBC	Wabco Holdings Inc
WBK	Westpac Banking Corp
WBS	Webster Financial Corp
WBS-F	Webster Financial Corp [Wbs/Pf]
WBT	Welbilt Inc
WCC	Wesco International
WCG	Wellcare Group
WCN	Waste Connections Inc
WD	Walker & Dunlop
WDR	Waddell & Reed Financial
WEA	Western Asset Bond Fund
WEC	Wisconsin Energy Corp
WEI	Weidai Ltd ADR
WELL	Welltower Inc
WES	Western Midstream Partners LP
WEX	Wex Inc
WF	Woori Finance Holdings Co. Ltd
WFC	Wells Fargo & Company
WFC-L	Wells Fargo & Company [Wfc/Pl]
WFC-N	Wells Fargo & Company [Wfc/Pn]
WFC-O	Wells Fargo & Company [Wfc/Po]
WFC-P	Wells Fargo & Company [Wfc/Pp]
WFC-Q	Wells Fargo & Company [Wfc/Pq]
WFC-R	Wells Fargo & Company [Wfc/Pr]
WFC-T	Wells Fargo & Company [Wfc/Pt]
WFC-V	Wells Fargo & Company [Wfc/Pv]
WFC-W	Wells Fargo & Company [Wfc/Pw]
WFC-X	Wells Fargo & Company [Wfc/Px]
WFC-Y	Wells Fargo & Company [Wfc/Py]
WFE-A	Wells Fargo Real Estate Invt Corp [Wfe/Pa]
WGO	Winnebago Industries
WH	Wyndham Hotels & Resorts Inc
WHD	Cactus Inc Cl A
WHG	Westwood Holdings Group Inc
WHR	Whirlpool Corp
WIA	U.S. Treasury Inflation Prot Secs Fd
WIT	Wipro Ltd
WIW	U.S Treasury Inflation Prot Secs Fd 2
WK	Workiva Llc
WLH	William Lyon Homes
WLK	Westlake Chemical Corp
WLKP	Westlake Chemical Partners LP
WLL	Whiting Petroleum Corp
WM	Waste Management
WMB	Williams Companies
WMC	Western Asset Mortgage Capital
WMK	Weis Markets
WMS	Advanced Drainage Systems Inc
WMT	Wal-Mart Stores
WNC	Wabash National Corp
WNS	Wns Ltd
WOR	Worthington Industries
WORK	Slack Technologies Inc
WOW	Wideopenwest Inc
WPC	W.P. Carey & Co. Llc
WPG	Washington Prime Group Inc
WPG-H	Washington Prime Group [Wpg/Ph]
WPG-I	Washington Prime Group [Wpg/Pi]
WPM	Wheaton Precious Metals
WPP	Wpp Plc ADR
WPX	Wpx Energy Inc
WRB	W.R. Berkley Corp
WRB-B	Berkley[W.R.]Corp [Wrb/Pb]
WRB-C	Berkley[W.R.]Corp [Wrb/Pc]
WRB-D	Berkley[W.R.]Corp [Wrb/Pd]
WRB-E	Berkley[W.R.]Corp [Wrb/Pe]
WRE	Washington Real Estate Investment
WRI	Weingarten Realty Investors
WRK	Westrock Company
WSM	Williams-Sonoma
WSO	Watsco Inc
WSO.B	Watsco Inc Cl B
WSR	Whitestone REIT
WST	West Pharmaceutical Services
WTI	W&T Offshore
WTM	White Mountains Insurance Group
WTR	Aqua America
WTRU	Aqua America Inc 6.00% Tangible Equity Units
WTS	Watts Water Technologies
WTTR	Select Energy Services Inc
WU	Western Union Company
WUBA	58.com Inc
WWE	World Wrestling Entertainment
WWW	Wolverine World Wide
WY	Weyerhaeuser Company
WYND	Wyndham Destinations Inc
X	United States Steel Corp
XAN	Exantas Capital Corp
XAN-C	Exantas Cap Corp [Xan/Pc]
XEC	Cimarex Energy Company
XFLT	Xai Octagon Floating Alt Income Term Trust Compa
XHR	Xenia Hotels & Resorts Inc
XIN	Xinyuan Real Estate Co. Ltd
XOM	Exxon Mobil Corp
XPO	Xpo Logistics Inc
XRF	China Rapid Finance Ltd ADR
XRX	Xerox Corp
XYF	X Financial
XYL	Xylem Inc
Y	Alleghany Corp
YELP	Yelp Inc
YETI	Yeti Holdings Inc
YEXT	Yext Inc
YPF	Ypf Sociedad Anonima
YRD	Yirendai Ltd
YUM	Yum! Brands
YUMC	Yum China Holdings Inc
ZAYO	Zayo Group Holdings Inc
ZB-A	Zions Bancorp N A [Zb/Pa]
ZB-G	Zions Bancorp N A [Zb/Pg]
ZB-H	Zions Bancorp N A [Zb/Ph]
ZBH	Zimmer Biomet Holdings
ZBK	Zion Bancorp
ZEN	Zendesk Inc
ZF	Zweig Fund
ZNH	China Southern Airlines Company
ZTO	Zto Express [Cayman] Inc
ZTR	Zweig Total Return Fund
ZTS	Zoetis Inc Cl A
ZUO	Zuora Inc
ZYME	Zymeworks Inc
